30,30
.@..@.@..@@....@..@@...@......
...........@.@......@@....@...
.............@..@@...@......@.
....................@.........
...................@.........@
....@......@..................
............@...........@@....
@........................@@.@.
.....@.........@..........@...
.................@@@....@@..@.
....@........@...@@.........@.
.............@...@....@...@..@
...@.@@..@....................
@.................@........@..
.......@............@.........
..............@.........@.....
........................@.....
........@...@..........@......
............................@.
.........@..@.........@.......
.@............................
........@......@....@....@.@@.
......................@.......
.@....@@..@...................
.......................@......
...........@..................
......................@.....@.
..............@..............@
....@@........................
......@.......................
