30,30
............@....@............
...@......@...................
..............................
...@...@.....@...............@
........@........@@...@....@..
.@............@........@..@...
.....@.......@........@.......
............@@.....@..@.@....@
.....@......@....@......@.....
..@..@........................
........@......@.......@......
...........@..........@.......
..........@@.@....@....@......
.......@.........@...........@
..............@...........@...
.............@...........@....
............@.................
.@....@..............@........
.@...@....@...............@...
.@...@........................
...........@.......@..........
.........@...........@........
.....@.........@..............
...@.@...................@....
...@..@........@.....@....@@..
......@................@....@.
.@.......@..@.............@...
.....@......................@.
.......@.@..........@.........
...@@.......@.@...............
