30,30
..@..@@@@...@.@.............@@
...@........@.................
..........@..........@........
........@....@................
...@..@..............@.@...@..
............@.................
...........@........@.........
.......@.....@.....@..........
..@...................@.......
..............................
........@.....@.@.@..........@
..@...................@...@@..
.............@...@............
@................@.........@@.
.........@@.@.................
@.............@..@...........@
.........@...................@
................@......@......
@............................@
@..................@@.........
..@.@............@..@.....@...
......@..@@...@..........@....
.........@.........@..........
..............................
..............................
@@...................@........
...@...........@@...@.........
...@.@...@....................
..........@.@...........@.....
@.@..........@..@...........@@
