30,30
......@.......................
..............@.........@...@.
......@..@....................
...@...@..@...........@....@..
...@.................@......@.
..@@..........@.......@.......
........................@...@.
.....@....@@........@.......@.
....@..@..@...@.....@@........
.............@..........@...@.
@...@.@..@....@...@...@.......
.......@...@..@...............
.@.................@....@.....
....@.....@....@...........@..
...............@..............
......@..@@.................@.
.............@......@......@.@
...@................@.........
..........@...................
...@.............@.........@..
...........@..................
....@.........................
.@...@.@........@...@.@..@....
.........@....@..@......@.....
........................@.....
..............................
..............................
........................@.@...
.@.......@...........@....@...
@....@............@........@..
