30,30
.@...@.............@.@........
....@@....@.....@.............
...@...........@.............@
..............@...............
.@............................
...@@..@....@@................
............@.................
..........@.@...@..@..@...@...
.........@......@.......@.....
.....................@.....@..
..............................
....@........@...@............
@.......................@.....
...............@....@....@....
@.............................
......@...@...................
..@.@.............@@....@....@
.@...........@@............@..
.....@@.@.@...@...............
..@.@.........@..........@@...
......@................@......
...........................@.@
.....@........................
.........@.@..................
@....@...@......@........@....
...@..........................
@....@.......................@
..@...............@.@.........
@.....@..........@...@..@.@@..
.....@.................@...@..
