30,30
....................@@........
................@........@....
......@.@.........@...........
.........@........@...........
.........@.........@@....@@...
@...............@............@
.....@.@.@....................
...........@..................
..@.@..@.@.........@.........@
@@................@@@.........
.........@.......@............
.@.......@.@.....@..@.........
..............@...@..........@
...@.@............@...........
..................@...........
..........@..........@....@...
............................@.
.@....@.............@.@.......
............@..@..@@......@...
..@...@..............@........
.................@.........@..
..@......@.......@@@..........
....@.@.............@.....@...
..............@@..@........@..
..........@...........@.......
.......................@......
........@.@........@..........
............@.....@...........
..............................
........@@..@........@.......@
