30,30
.@........@.@.....@...........
....@.........@..@@.@........@
.................@..@.....@...
.@..@................@........
............................@.
....@.............@......@....
..@.............@@...@.....@..
.........@@..@...........@....
.....@..........@.@.@.........
......@..............@........
............@@................
...............@.....@........
..@....@.....@..........@@...@
....@............@.@..........
.....@...........@............
...@.......@.........@......@@
@.................@...........
..............@....@.....@..@.
.......@.....@@...............
.............................@
................@.............
......@........@..........@...
............@................@
...................@@.........
.......@.@.@..................
................@.......@.....
.......@..@......@............
.....@.....@......@...@.......
...................@....@.....
......@...@...@...............
