30,30
..@.........@...@.............
.....................@@.......
..........................@...
........@............@...@.@..
.....@.....................@.@
..........................@...
........@........@...........@
...@...@....@@..@.......@.....
...................@..@.......
......@....@....@........@....
...@@.........................
....@..........@..@..........@
.....................@.....@..
@.......@....@.@.....@........
..............................
.........@..........@.........
..@..........@...@......@.....
.........@...................@
.........................@....
.......@@......@.@....@.......
......@...@@.............@..@.
.................@@.@.........
..@..@........@@...@......@...
........................@.....
............................@.
.........@..@@.........@......
@..@...............@@.........
...................@.....@..@.
...@..@....@@.................
@......@......@...............
