30,30
...........................@.@
......@.........@.@........@..
......@...................@...
...............@..............
..................@@........@.
@............@.............@..
....@.......@@.@.....@....@.@.
@......@.....@................
@................@............
.....@.......@@........@.@....
@..@.........@................
............@....@............
.....@.....@....@@.......@..@.
...@...@.............@..@..@..
......@...@.................@.
...........@............@.....
..........@.......@.......@...
...........@.@............@...
............@..............@..
.....@........@...............
........@@....................
..@..@....@...................
....@..............@@.........
.....@.@......................
....@..............@....@.....
..............@.@.@...........
..........@.................@.
..........@...................
...@...@.......@@@...@..@.....
....................@.........
