30,30
..........@..........@........
...................@.@@.......
.................@...@........
.......................@......
......@@...@..@..@..@.........
...............@@........@@...
..............................
.....@.....@........@.@.......
......@......@@...@...........
.......@.@.@............@.....
.........@.......@............
...@...........@....@.........
....@.@@.@................@...
.........@..@..@......@.@.....
................@.@...........
..................@......@....
....@.......................@.
...@.....@....@....@.@....@.@.
............@..............@..
.....@....@.....@.............
..............@...............
.@.@........@........@...@....
......@..............@.@......
.................@.....@..@...
........@.....................
.....@........@........@.....@
@........................@....
............@..@..@.@.........
......@.............@.........
................@@............
