30,30
@.@.@.........................
.......@................@..@..
.@.....@..@.................@.
.@....@.......................
.........@..@..........@....@@
.................@@..@@@......
.@..........@................@
.........@..@..@......@......@
...@@.......@.....@..@........
.@.@..@.......@...............
...@@.................@.......
...@.@..........@.......@...@.
................@.@@..........
......@........@...@....@.....
.........@....................
...........@.................@
@.............@..@...........@
..............................
.......................@.....@
.....@.......@......@........@
..............................
....@...............@.........
.............@..@............@
.....@..@....................@
.........................@....
...........@@............@..@.
...........@......@...........
..............................
...@@..@...........@......@...
...@......@@..................
