30,30
....................@@...@..@.
........@...@.......@.........
............@.................
@@@...........................
...@.........................@
...........@.@.........@......
..@@.........@...........@..@.
.................@.@...@......
..........@.....@@....@.......
..............................
........@...........@@........
@..........@..@...@.....@..@..
..........@...................
....................@.......@.
@...............@..........@..
...........@.........@...@....
..................@....@...@..
@.......@..............@......
......................@.......
........@...@@.@.........@@...
......@..@.@..................
..........@.......@...........
..............@...............
..@.@.....@.@...@.........@@..
....@..........@.....@...@....
.....................@........
.....................@......@@
.....@@....@..@........@......
..............................
@.............@@..........@..@
