30,30
..........@.@.......@....@...@
......@.........@.........@...
...@...............@.......@..
.........@.....@..............
..............................
........................@.....
........@..@.....@.....@...@.@
.....@.........@..............
..@.@..@......@......@........
.........@............@.......
@..@.......@........@.@.......
@........@@........@...@......
....@.......@............@....
.......................@......
......@...................@...
@.........@.@.........@.......
.................@...@........
@.............................
...........@.@.......@........
.@.....@......@...@.....@.....
.......................@......
..@........@..@...............
.@...............@..@.@.......
...@.@......@.................
.......@...........@.@........
.........@...@..@.....@.......
....@..@..............@.......
.......@.@....@@....@...@.....
..........@...................
..........@..................@
