30,30
.@.........@..@............@.@
.@.......@....................
...................@..........
..@......@.....@..@...........
.....@@@...........@..........
.@............................
..@.........................@.
.....@......@.................
............@....@......@@.@..
.......@.......@..............
.@............................
..@...........................
......@.........@....@........
...@...@@..@.......@...@@...@.
.@.........@...@@...........@@
.......@....@@...@............
...................@..@.......
.@.@..........@.......@....@..
...@...@.......@.....@........
....@...................@.....
...@...@......................
.........@..@.................
...................@..........
.@......@......@...@......@...
..@..@.@.........@..@.........
....................@.........
.....@................@.......
................@.......@@....
.@...............@...@........
.......................@...@..
