30,30
...@..........................
.......@....@................@
.............@...@.....@......
..@............@..............
.......@..............@...@...
...................@..........
....@................@........
....................@.........
.....@....@.@............@....
@.........@..@.@.............@
.@.@.........@........@.......
...............@..............
.....@..............@@........
...@...@......................
@..@................@....@....
.......@............@..@......
....@..@..@...................
@....................@......@.
....................@.@.......
@..@...........@....@.........
........@.........@..@........
@....@..@.....@...............
..........@......@.@@......@..
..........@...................
.@.....@....@....@...@@.......
........@@......@.....@...@...
.......@.................@....
........@..@....@@..........@.
@.............................
...@..........@......@@.......
