30,30
.@.....@....@.....@....@..@...
...........@..................
.@...@@.......................
........@.......@...@...@@....
.......@.............@....@...
.......................@......
.............@.@..@........@..
..@.................@.........
...@........@...@.........@...
.....@...................@...@
...........@..................
...@....@.....................
...................@......@...
...@.......@.......@..@.@@....
......@@@..........@@.........
..................@...@.....@.
.@...@@@.....@.@.@............
.............@........@......@
...@.@...........@..........@.
..............@.......@.......
.....@..............@.........
.....@..........@........@..@@
.....@.............@..........
.................@@...........
..............@...............
@......................@......
.....@..@............@........
.........................@....
..@......................@....
@.....@..........@............
