30,30
....@.@.......................
...........................@..
......@...............@.......
.........@...........@......@.
............@.@....@..........
..............................
@@...........@................
.......................@@.....
@@.@@....................@....
................@....@........
....@@..@.....................
....@.............@@....@.....
....................@........@
..............................
......@@......................
........@.@...@.@..@.@...@....
.....@...............@...@....
..................@.......@..@
....@.........@....@@....@....
.......@.....@...@............
.....@.......@..@...........@.
..@.@...........@..@..........
.................@......@.....
@..........@....@.............
...................@....@....@
...........@...@......@@.....@
.......@...@..@..@@.....@..@..
.......@......................
.@............@...............
@....@.........@....@.........
