30,30
.....@.@@..@.........@....@.@.
..............................
..@...........................
.............@@........@......
...........@.@................
..@............@.....@........
...............@.........@....
......@......@........@@@...@.
..........@.....@......@......
....@..........@..@..@......@.
............@.................
.........@................@...
.......@......................
....@......@...@.@...........@
@..@@.@......@................
..@.......@..@@...............
....@.............@....@......
.......@.......@....@.........
........@...............@.....
.....@........................
..............................
..........................@...
..@.....@.................@...
@.....@....@..................
.............@.........@......
..@....................@@.@.@.
...........................@..
@......@..@......@.@..........
@@........@.............@.....
.....@.@......@@....@@.......@
