30,30
.@...@........@..@.....@...@..
.........................@....
.@...@......................@.
...@.@..@.........@@..........
......................@.......
....@....@..@........@...@..@.
....@.........................
..........@...@...............
.@..............@.........@...
.@..........@...@.......@.@...
...@.......@..........@...@...
..@.@....@....................
@........@......@....@@.......
@..........@............@.....
............@.................
........@@.@....@.............
...@................@.........
................@.............
.........@................@...
...@........................@.
@....@......@..............@..
.......@.@........@.....@.@...
@...................@....@....
@......@...........@........@@
..............................
........................@.....
...................@...@......
......@................@@.....
...@.@...@....@.....@.........
...............@.......@......
