30,30
...........@..................
@...................@@...@@.@.
..@...........................
....@.......@..@.....@....@...
..@......@..........@@........
..............@......@@.......
....@...................@.@...
..@...........................
....@..........@.@..........@.
..@..........@....@...........
...........@..................
...@@...@..@.............@....
..............@....@.....@.@@.
.....@........@.....@.........
............@.@............@..
.@......@....@................
........@@.................@..
...........@................@.
.....@..@......@....@.........
..............@...............
....@.@.....................@.
............................@.
...........@..................
.@........................@...
..@.@...@....@..@.............
.@........@.....@.@...@.......
...@.....@...........@.....@..
...@................@.@@......
..@...................@..@....
.........@....................
