30,30
.....................@....@...
........@@@.............@.....
........................@....@
...@..@......@.@...@..........
.@...........@..@.@...........
.............................@
........@.....@.............@.
....................@..@..@...
....@.@.......................
@..........@..................
...........@...............@..
.@...................@@.....@.
..@...@...............@.....@.
.........@..........@.........
.@......@.....................
@.........@...................
.@.@.....@..........@......@..
..............@........@...@..
...........@..................
..@...........@...@.........@.
@...........................@.
@.....@.......................
...@........................@.
..........@...........@.......
.@.....@..@........@..........
..........@....@.@....@.@.....
....@..............@.....@...@
............@@.@............@.
@...............@.....@.......
...@....@.@............@.....@
