30,30
..@..........@@..............@
.................@@..@.@......
...@..........@@.@.....@......
..@...........@..............@
..............................
..................@...........
.................@...@.@......
......@..@.@.......@......@..@
.@....@.....@.................
..@.......@@.......@..........
....@@....@...................
..@@..........@..@..@........@
.@.............@...@..........
...............@.@.@.......@..
.@..@......@....@......@.@....
.......@@.@...........@.......
...................@.@........
................@.............
............@.....@..@........
....@..........@........@@.@.@
.....@.........@..............
..............................
...........@..@............@..
....@................@.....@..
............@.................
....@.........................
@................@.@.@........
..............................
...............@........@.....
........@..........@..@.......
