30,30
..................@.@......@..
....@...@........@............
..................@........@..
..............................
...@.......@.....@..@.........
.....................@.......@
..@...@...........@...........
....@............@.......@@...
..@...............@...........
...@@@........@.........@.....
........@@...............@....
.@.......@....................
....@.....@........@.@..@..@..
.............@......@.........
@........@.@..................
........@....@.@.......@......
..........................@...
.......@.........@.....@..@.@.
...@.................@........
@..............@....@.........
........@.......@...@@.@@...@.
..............@...........@...
........................@.....
.....................@........
..............................
...@..................@.......
..@..............@....@..@....
...........@.@@.@.............
..........@...........@.@.@...
........@....@@.@..@.@........
