30,30
.......................@......
.....@....@..@................
...........@...@....@.........
.....@...............@........
.....@......@..@..........@@..
......@.................@.....
......@...@.............@..@..
..@.........@.................
.......................@...@..
........................@.....
........@..@......@........@..
.............@....@.......@...
..................@...........
......@.@.....................
.....@.............@@......@..
...@.........@.@......@.......
..@..@..@.......@..@.@..@.....
@........@...........@@.......
.........@@..@..@...........@.
..............................
....@........................@
....@.......................@.
..@..@...@..@.................
....@...@.....@...............
...@.@........................
..........@................@..
..@........@...@@.............
......@...........@...........
..@.@.........@........@...@..
........@....@...@..@....@....
