30,30
................@....@........
.@......@.............@....@.@
..............................
................@....@........
.....@.......@................
.....@..@.......@..@..@...@...
....@......@..................
.........@........@..@........
......@..@@..@...@............
....@.......@......@..@.......
.@.....@@..........@..@...@...
..............@............@.@
..............@...............
..............@.............@.
....@.....@...................
.............@.....@..........
......@..@............@.......
.......................@......
.@..@..@....@.................
@@..@................@.......@
............@........@..@.@.@.
.....@....@..........@........
..@..........@.......@...@....
........@@.....@............@@
...@....@........@........@...
................@........@....
...........................@..
..........@..................@
..........@@.............@....
..@...........................
