30,30
..@...@.@@...@................
....................@.........
...@...@......................
..............................
...................@.@.....@@@
...........................@@.
..........................@@..
@............@............@.@.
..@...................@.......
........@.@.......@.@.@..@....
.................@...@........
......@........@......@@@...@.
..@....................@@.....
@...@.....@...............@...
@............................@
..@...@......@................
.............@...@..@.........
@..........@..................
...............@..............
........@...........@.........
.......@..@......@............
........@.@....@.@..@.....@...
.......@......@...........@...
.....@............@..@........
....................@......@..
..........@.@@............@...
@...@..........@.......@@...@.
............@...............@.
.............@.........@......
......@......@................
