30,30
..........................@@..
.......@..@...................
......@......@.....@....@..@..
.............@....@....@......
@...........@.................
@........@.......@.@..@.......
.@..............@...@......@..
........@..........@.........@
...........................@..
.....@...................@....
....@.......@........@.......@
...@.@@....................@..
.............@.....@......@.@.
...........@.........@........
@.............................
...........@.......@@..@......
......@.......................
...@....@.@...................
...@............@.............
.@....@.@..........@.........@
.........@.....@..............
..............................
.@...@..@..@...............@..
@...@.................@...@...
..@..@.......@................
.........@.@.......@.....@....
....@.........................
..@..........@...........@....
..@.....@@....................
......@@....@...@..@......@...
