30,30
..............@........@......
.@.....@@........@..@.....@@@.
...@......@......@.........@..
.@..............@.............
..........@@..@...............
......@........@...........@..
..@...........................
@..............@.......@......
.......@.....@..@........@..@.
.................@........@...
....@......................@.@
..@@....@.......@....@......@.
........@...........@@@.......
...@.........................@
.@...@@............@.@.....@@@
............@.@.......@@......
.........@..........@.........
..@...........................
..@...................@.......
..............................
.................@.........@..
...........@.........@........
@......................@......
............................@.
.......@.......@...@......@...
.@.........@...@.....@........
..............@..@............
..............................
................@.......@@...@
...@.......@..@........@......
