30,30
..................@....@......
..@...........................
.........@....................
.........@.@...........@...@..
.............@.@...@.........@
@....@..@..@.........@@.......
.@@....@...........@.@@....@..
.............@................
.....@..@....................@
..@....@.........@...@......@.
..@................@....@.....
.........@...@..@...@.........
...@..........@...............
......@.......................
....@....................@@...
...........@...............@@.
....@..........@..........@@@@
..@.................@.........
@..@.......@.......@.......@..
.............@...............@
..@....@......................
..@............@..............
.......@.............@.......@
......@....@.@................
.........@.............@......
@..................@..........
@@...@........@...............
.............................@
...........@...@@......@..@...
......@.......................
