30,30
......@.......................
.........@....................
.@...@...@......@..@@......@..
........@..@.........@...@....
........@@@...................
......@.....@......@..@.......
@................@............
...@..........@...@...........
.......@........@.............
...@............@.@@..........
@.......@...........@..@...@..
........@..............@..@...
..............................
@@...........@.......@...@....
.......@....@........@........
....@....@................@.@.
...@..@..@............@.......
...@.......................@..
..............................
@..........@.....@..@.........
...............@.........@....
.........@....@.@.............
.........@.@..................
..@..............@............
............@.........@@......
................@.@...........
........@.......@........@@...
.@.@...@..@.................@.
....................@.@.......
.@.............@.@...@........
