30,30
.......@@...........@........@
@....@................@.@..@..
............@@.....@.@........
..................@....@......
.........@........@.@@.@....@.
..............................
............@@..@@............
.@@..@....@............@......
.....@..@..................@..
.....@.@.....@.@....@......@..
.@...................@.......@
....@.......@...@..@..@.....@.
...@...@.......@...@..........
......@..@....................
..............................
......@..............@.@......
..@.@.@......................@
....................@.........
....@.....................@...
..............................
.........@........@...........
..@...............@...........
.@.............@....@.........
@.............................
...............@..@.....@@....
...........@..............@..@
...@......@...@.......@.@.....
....................@......@.@
........................@.....
.....................@...@....
