30,30
....@.........................
...@.....@.....@..............
.@.......@...................@
............@..@..............
.@.@@.............@.........@.
..@...@......@............@...
.............................@
...@..........................
.....@........@...............
.....@.....@..@..@@...........
.....................@........
@............@.....@..........
.........@..@......@..........
........@....@............@...
...................@..........
.....@..@.....................
........@..@@@............@@..
.....@...@....@.....@...@.....
......@.......@.........@...@.
.......@...@..@............@@.
......@............@..........
.@............................
........@..........@.@........
..................@...........
..@...@@.@............@.......
....@@.@......................
....@............@..........@.
.@........@..@..@.............
....@.......@...........@.....
...@.........@.@@........@....
