30,30
.@@.............@....@........
..............................
....@..@....@.....@.........@.
...@.........@.........@@....@
..........@...................
............@.@...@...@..@...@
....................@.@.......
..........@...@.@.@...........
..............@..@............
......@................@....@.
.@............................
................@.....@.....@.
....@.......@.@...@..........@
..............................
...........@@.................
.@.....@@...@......@..........
..................@........@..
.................@............
.....................@........
.@..............@.......@@....
....................@.@...@.@.
....@............@..@.........
....@................@........
@..................@@....@.@..
....@...@.......@...@......@.@
...................@..........
@...@...........@@............
.@.................@...@......
....@......@.....@.@..........
...............@@.............
