30,30
..........@............@......
.................@....@.......
........@...@@..........@.....
..................@..@@.......
............@......@..@.......
......................@.......
...........@...@..@......@....
..............................
............@.@...@...@..@@...
...........@.@@.......@...@...
...............@..............
...........@.....@..@.........
.........@........@......@....
.............@......@@........
@.............................
....@.........................
..................@....@.....@
@......@..............@.......
.......@@.................@...
.................@@........@.@
........@.@......@@...@.......
........@......@@.............
................@........@....
.........@...........@.......@
.........@.......@......@.....
...@.........................@
@@....@..................@....
.....@......@....@@.........@.
..@........@........@@@@......
@............@................
