30,30
..@...............@...........
@..@......@..............@@...
..@...@...............@...@...
................@@............
.@........@...................
..............................
....................@.@....@..
....@..@.....................@
..@......................@....
.....@@.@...........@.......@.
.......@..@..................@
.....@........................
.......@.......@.......@......
@@................@@.@...@....
..................@...@.......
@......................@@...@@
.......@..@@...@...@..........
........@....@.....@.......@..
............@..@..............
.....................@...@...@
...@......................@..@
........@..........@....@.....
...............@.......@.@....
......................@.......
..............................
....@.................@.......
.................@.......@....
.@...........@...@@...........
......@........@@...@......@..
..@.......@.....@@......@.....
