30,30
....@.......@@................
..................@.........@.
...@..........................
..................@...@....@.@
.......@....@@................
...@............@...@.........
.............@.........@@..@@.
..................@...........
.........@....@...............
..........@..............@....
.......@......................
.................@............
........................@.....
....@@@.............@........@
............@..........@......
....................@......@..
.....@..........@....@........
...................@......@@..
...@@.....@@...............@..
.....................@.@......
@.........@..........@..@...@.
....@................@........
..@........@.@.......@...@.@@.
..........@.........@.........
........@..@..........@.......
...@.........@..@..........@..
@.....@.......................
.@..@@.@........@.............
.........@@.@.........@..@@...
@............@.............@..
