30,30
...........@@.........@.......
...@..........@..@........@...
...@....@.....@...@......@.@..
...................@..........
...........@..........@@......
........@....@......@.........
.................@...@@..@....
...@..@...@...................
..@...............@...........
.@.................@..@.@.....
......@.......@...............
......@.................@....@
..............................
....@.........................
.........@........@...@..@....
...........@....@....@........
...........@.@..@.............
..........@...................
.............@....@...........
...............@...@@.......@.
.............................@
.............@..@....@........
..........@@....@....@.@.@....
...............@@....@....@.@.
...................@........@.
@......@.@...............@....
................@..........@..
.............@................
@.@@............@.@..@......@.
....@........@.......@........
