30,30
...@..........@.@.@@..........
@.........@............@......
.......@..............@.......
...........@................@.
.@.........@......@...........
.@@...@..............@........
..............................
.................@.....@....@.
@............@..........@.....
...........................@..
..@..................@........
.....@...........@............
.......................@......
...@.@...@.@......@...........
..........@...........@@......
..@.................@.@.......
............@.@............@..
.................@.@.@........
..@.......@..@.....@....@.....
.@.....@@......@..@.........@.
.....@....@@....@..........@..
...........................@..
..@.@.....@...................
...@..........................
..............................
.......@..................@@..
..@......@...@......@...@.@.@.
.@.@....@...@.................
.....@................@...@...
.......@.@...@.......@........
