30,30
................@@............
..@.........@........@@.......
@@.................@.......@..
...@........@............@...@
........@.....................
....@....@.@@..........@......
..@..........@......@.........
........@.@...........@......@
.........@...................@
..@...@.......................
...@@...........@...@@@@......
..@..........@......@.........
..@.@...............@.........
..@.@.............@........@..
.@........@.@@...............@
..........................@...
.......@..@..@................
.......@............@....@....
..................@........@@@
.................@...........@
.....@........................
.@....................@.......
...@...@..........@.......@...
...........@............@.....
.@............................
.....@.....@.@...@...@...@....
..............................
.@........@.......@...........
..............@.........@....@
............................@@
