30,30
.@...............@..@...@.....
.........................@....
.@...........@.........@....@.
....@@......@.@.@....@...@@...
..............@.....@.........
............@.....@.@.........
.................@............
....@@..@@.........@........@.
..........@.....@.............
..........................@...
..............................
...@.....@.@..................
.@............@...@...........
..............@......@.@......
..@...........................
........................@...@.
.@.@.............@........@...
..................@.@.@@....@.
.@..............@...@.@....@..
...................@@.........
.............@........@.......
..........@..........@........
@.....@................@..@...
...........@@............@....
..............................
...@.....@......@.............
.....@.....@..@............@..
.......@...@....@........@....
......@.........@...@@.@.....@
...............@...........@..
