30,30
.@.......@...@..@@..........@.
........@...@...@.............
.............@.@..........@...
@..@.....................@....
...@................@@....@...
.@@........@..........@.......
........@....................@
@@............................
..@...........................
...@.@......@.................
........@............@..@.....
....@.@................@.@....
....@..........@@......@......
................@.............
..............................
............@@.@..............
...........@.....@........@...
...........@....@@@@.@.@.@....
..............................
............@..........@@.....
...@.....................@....
...........@..@...............
.............@..@.............
.....@@..@.....@..............
@..........@.....@....@.......
..@.............@.....@.......
.....@.........@...@..........
........................@.....
....@...@.....@...............
@.......@......@...........@@@
