30,30
.....................@........
...............@........@@....
............................@.
....................@.@......@
..............................
..@@.@.@@..@.........@........
..............@...............
...@.........@...@.......@....
.@.@@.....@.@...@..@..........
..........@.............@.....
.........@..@...@.........@...
..@......@.........@.........@
..............................
..............@...@.......@@..
........@.....................
..........@.....@.@......@.@.@
...@.....................@....
............@.....@..@........
................@..........@..
.........@......@.............
.......................@.@.@..
...@.@..................@....@
.......................@......
..............@...............
.@....................@..@....
..@@..@..@@..@@..............@
...@.@......................@.
...........@................@.
.@..........@...@.@....@......
....@.@...........@...........
