30,30
.......@......................
..@..@........@.....@....@....
.@...@........................
.@.@...@...@....@.............
..............@......@........
............@@..@...@.........
.........@.........@..........
.@.....@.......@@......@.@....
.......................@@.....
.....................@...@.@..
........@@.@................@.
@....@...................@..@.
........@.....................
.......@...............@@.....
....@....@........@.......@...
................@.............
@......@..@..@....@...........
............@...............@.
.....@.@.@..@.................
.@....@......@@..............@
.........@...................@
............@............@....
....................@..@@..@@.
..............................
...@.........@................
....@.....@.............@.@...
....@..@.......@......@...@...
................@...@.........
.............@.......@..@.....
..............................
