30,30
................@.............
@@........@.....@..@..........
.........................@...@
........@.................@...
.....@.@..@...................
....@...........@.............
.@@.......@@.........@.....@@.
..................@@...@......
...........@............@..@.@
..............................
.......@....@..@..............
......@.@.......@..........@..
.............@@...............
..@..@.............@.........@
..@....@....@.......@..@......
................@..@..@@.@....
.....@.....@..........@.......
.....@........................
@....@.................@......
.@..................@.........
....@...@.@....@..@..@..@.....
..@......@................@...
........@.........@...........
..............................
.........@...............@..@.
..@...@..@....@...........@...
.........@....@.......@.......
....@..........@..............
@........@..............@.....
......@.......................
