30,30
..@.......@...................
........@@....@.......@...@...
......@.........@@............
.......@.@..@...........@.....
.@......@........@...........@
.......@.............@...@....
@.............................
..@................@@.........
...@........@..............@..
.............@...@@...........
................@........@....
....@.@......@..........@.....
.......@......@...............
...............@.......@......
........@...@............@....
...........@..................
....@.......@......@....@...@.
.................@............
.@............@@..............
.........@....................
.........@.............@..@...
..............@...........@...
.....@.@.@.@...............@..
@....@.@...@.@...........@@...
.@.....................@......
..@...........................
.....@..................@@....
..........@.....@@......@...@@
........@...........@....@....
........@...................@@
