30,30
............................@.
.............@.@..............
...........@.@@...............
@...@.......................@.
..............................
....@....@.@.@......@....@....
..............................
@.............@..........@....
..............................
.....@.......@......@.........
............@@................
..................@@.......@..
........@.@@.@................
.@........@@.......@....@.@...
...............@.......@......
....@.........@...............
...@............@.............
...@..........@...............
.........................@@...
@..@....@.......@.............
....@@......@...@.@...........
@..@.....................@...@
...........@....@....@......@.
@..........@...........@.@.@..
........@.....................
.........@....@.......@......@
..@..@.......@.......@........
@...@...........@..........@..
.........@..@.@....@.@......@.
..........@......@...........@
