30,30
...@..........................
........@..@.....@............
..............@............@..
.....@................@.@.....
.@...............@......@.....
........@...@...@.............
......................@.......
@..........@..................
............................@@
..@..........@................
....................@@........
.@................@........@..
.....@...@.@......@.......@...
.........@..@.........@.......
.........@.........@....@.@.@.
............@.................
...@@@.................@.....@
.@...@...@.@..@..@.......@....
.@............@........@@.....
...@...........@.@@.@....@....
....................@.@.......
............@....@.......@....
...@...............@..........
..@.....@.....................
.......@........@.........@...
....@.@.......................
@...............@............@
.....................@.....@..
........@.....@..............@
......@.....@....@....@...@...
