30,30
@............................@
......@@.......@......@.....@.
@................@.@..........
......................@.@.....
...........@@...............@.
.@......................@.....
@.@....@..@...................
..@...@......@..@.........@...
.....@...............@........
........@......@........@.....
..@.........@..........@.@....
....@.@....................@@.
........@...........@.........
@.........@.......@...........
.......................@......
@.............................
....@................@........
@@..@.........................
...@...@..@.@......@@.........
....................@......@..
.................@..........@@
......@..........@..........@@
....@....@..........@.........
.............@..........@.....
...@...@.......@.....@@....@..
..@...................@.......
@@................@...........
..........@........@..........
@.....@......................@
..........@.@..........@......
