30,30
............@..@..............
.........@.........@..........
...............@..............
......@.........@.....@.......
....................@.....@.@.
....................@@........
.@..........@................@
..@....@......................
@..@@.........................
................@@@...........
............@.................
........................@...@.
.......................@.....@
........@.@.....@.@...........
................@@.....@......
.@..............@.............
................@...@.........
...............@.......@..@...
.@...................@........
..........@.....@@...@....@...
....@..........@..@..........@
..............@...@.@.........
........@.....@.............@.
....@....@...@.@@..@.........@
.............@..............@.
......@@......................
......@@.....................@
....@.@.................@....@
.@@.............@.......@..@..
...@.@@......@......@@.@......
