30,30
..............................
@..............@..............
@......@..@...................
.....@@......@...........@..@.
.....@...............@........
......@..@....................
........@.....................
..@.....@........@.........@..
.....@.........@....@.........
@.@...@........@..............
......@..........@......@....@
....@@....@...........@.....@.
..............@......@....@...
..............@.........@.....
...........................@..
...@............@..@..@....@@.
...@.....@....................
...@..........................
..........@@@.................
....@.......@@.......@..@.....
........@.............@@......
.............@.@......@.....@.
........@....@..@.............
..@............@.......@...@..
......@.........@.@...........
..........................@@..
......@............@..........
@.@........................@..
....@.......@.@...@@..........
............@@....@...........
