30,30
..............................
....@.........................
................@.....@@...@..
.................@....@.......
...@.@..............@....@....
........@..........@..........
..@@.........................@
@......@@.@@.@.....@......@@..
@....@.......@...@..@......@@.
...@..@.........@...@.........
...@..............@.@...@..@..
..............@@.@.........@..
...........@@.@@..........@.@.
.........@...........@........
..@....................@......
...............@@......@......
.................@.....@...@..
..............@...............
.............................@
..@.....@.@...................
..............................
..@..........................@
..........................@...
....@......@..................
..............................
...@..@..........@.@..........
@@@..........@...@.....@@.....
......@.........@......@.@...@
@.............................
........@..@..................
