30,30
.@................@...........
..@........@............@.....
.@......@......@..@....@......
.................@............
...............@......@.......
.@..@...@............@........
...@.............@...@.......@
...@...@......................
......@.@............@........
................@...@.........
@.@....................@...@.@
...........................@..
.....@....................@...
.......@.....@@@....@.........
..............................
...........@..................
........................@...@.
@.......@@....................
.............@@@......@....@..
.....@....................@...
...................@.....@...@
@..@..........@.........@...@.
................@...@@..@.....
....@.........................
......................@.......
.........@.@......@....@...@..
.@....@...................@..@
.@........@...@...............
@..@@.....@@.....@@.@........@
..........@...................
