30,30
........@......@@.@..........@
........@@...@................
..@.......................@...
.......@.....@.........@....@.
...............@..............
...........@..........@.......
....................@.....@...
.....@..@.@..............@....
.@...@..............@.........
.........................@....
...................@..........
..............@.....@...@.....
....................@.........
.....@........................
......@....@.@@.@.........@...
.......@..@..@@...............
.....@.........@........@...@.
..@...@.........@.......@....@
.............................@
...@@..@....@......@....@.....
...............@...@...@.....@
......@................@.@....
.........@.....@....@..@......
.@........................@@..
................@.....@.......
..@..@.....@....@.......@....@
...@.@........................
.............@........@....@..
......................@.......
..................@@.....@....
