30,30
@...............@.............
.........@................@..@
..............@..........@....
...............@..@.......@...
........@@.......@@@........@.
.....................@........
................@.@@........@.
..........@...@............@..
@..........@.......@......@...
...................@.....@....
.@....@.@.................@...
..@...........................
.....@.........@.@.......@....
.........@.......@............
........@........@.......@....
@..............@.....@.......@
..............................
...................@.@@.@.@...
.............@...........@....
...@.....@@.......@....@......
...................@..@.......
..............................
..@.....@.....@....@.@........
.....@......@................@
......@@..........@...........
.@.@..@....@........@.........
..................@..@...@....
...@.........@......@........@
.....@.@.@@...................
@.............................
