30,30
...@..................@....@..
.@........@...........@@@.....
...........................@..
............@.....@.@.........
.........@......@@......@...@.
.............................@
....@@@.......@.@.......@....@
................@...........@.
..............................
....@.....@.........@.........
.@..........................@.
.......@.@......@........@....
......@..@.@...@.@............
.@..@.......................@.
..........@.......@.......@.@.
...........................@..
..............................
......@..@.........@..........
.......................@....@.
.........@........@.@.@.....@.
...@..............@...........
..@.........@.................
.......@....@..........@......
....@..@....@................@
...@@.........................
...@.........@.......@....@...
....@...@.......@.............
.@.......@....@........@@....@
........@......@..............
.................@.@.........@
