30,30
........@........@.........@..
.@..@@@.........@..........@..
@........@....................
......@........@....@.........
..................@..........@
..@....@.........@..........@@
..@........@...@.........@@...
...@...@......................
.......................@......
..............................
.................@............
..@.................@.........
.................@............
.....@............@@....@..@..
........................@.....
@...@............@.@.@.......@
........@@@@.@...........@....
......................@...@...
..................@......@..@.
..............@......@..@.....
..@..........@...@.@.........@
..@.@.....................@...
........@.....................
..@......@@....@...@.@......@.
.....................@........
.......@......................
..@...........................
@@....@............@........@.
...@........@......@..........
...........@..@@...@..........
