30,30
..........@...................
.............@................
...................@...@......
.......@..........@...........
.........@.............@......
..............................
............@.........@.......
.....................@........
...@..@...@.....@..@..........
...........@........@......@..
......@.............@.@...@..@
....@@..@.@...................
.............@...........@....
....@.............@..@........
@.......@...............@....@
..............@...@...........
@.@..@......@.....@...........
...........@....@@....@.......
.@...................@@.......
..............................
.......@..............@.......
..@...@.......@.@.@...@.......
...@.....@..............@.....
.......@........@....@......@.
..@.....@............@.....@..
..@........................@..
@..@....@.@................@..
.@.......@.@@...@....@.@@.....
...............@@...........@.
..@...................@.......
