30,30
......@@............@.....@...
.........@........@..@........
.......@@...........@.......@.
..............................
..............................
.@.....@...@@.................
.....................@......@.
@.@........@.@@....@..........
........@........@............
@...........@.......@@..@...@.
............@...@.............
..@.@.......@@.....@@.....@.@.
.....................@........
......................@.......
@....@..@.....................
..@...................@.......
....@.........................
..............@.......@.......
..@.....@.@@...........@......
.@.@...............@@.........
.@..@.....@..@..@....@........
................@.......@.....
.@...@@.......................
......@.......................
..........@@........@.........
..................@..@@..@....
..@.......................@...
.......@.......@..........@...
.@..@......@.@................
...........@........@.........
