30,30
..@@...........@..............
...@..........................
.........@....@........@.@....
..@...............@......@@...
......@.............@...@.....
.@..@.........@.......@.......
.......@............@.....@...
.........@..........@.........
............@.................
...@.@...@........@@..........
.........@...................@
.....@.@.....@.....@.@........
@..........................@..
.......@......@...............
...............@...........@..
....@...................@.....
......@...............@..@....
...@..........................
.....................@........
................@.@....@......
....@...@.......@....@........
.@...................@@.@.@...
.....@........@...........@@..
..........@.@.................
.@@....@@...@.@......@..@.....
@.@.....@....................@
..@........@.@....@...........
..@..........................@
.@.............@........@.....
.................@............
