30,30
.@.....@......................
.......@......@....@..........
....@.............@@..........
...@..@..@....................
.........@@...................
..@...@.....@.........@.......
.....................@........
....@................@...@....
.........@....................
.............@.@.@...@........
.................@@..@........
.........@........@......@....
..@......................@....
..@...@.......................
.@............................
@....@......@....@@....@......
.........@.....@..............
.......@..@..@@...............
@........@........@...........
.......@.......@............@.
.........@......@..@..@..@....
..............................
@......@....@...........@.....
...@..@@...........@..@.......
...@........@...@@....@.....@.
...@......@..........@@....@@.
...................@..........
...........@...........@......
..............@...............
@.......@.@@.................@
