30,30
..................@...........
............@..@.@@@..@....@@.
.....................@.@.....@
.@..................@.....@...
.@..@..@..@.@....@@...@...@...
..........@...................
..@.@.@.......................
@......@......................
...............@.@@...........
......@........@..............
........................@.....
...@............@..........@@.
@...............@..@......@@..
@........................@....
..............................
@....@@...............@.......
....@..............@..........
..............................
...@...@...........@@.........
....@.@.........@@............
............................@.
....@.........................
....@......@.............@....
.....@..@.@................@..
...........@........@.....@...
.......@...................@..
.......@........@...@.....@..@
......@.....@...@...@@........
@........@.....@.......@......
...@..........................
