30,30
.....@...........@.....@......
.@........@...................
......@.....@..........@......
...........................@@.
..............@..@..@.........
.....@.....@.......@..@.@.....
...........@.....@..@.........
....@...@.........@...........
...@..........@.......@.......
....@....@@...@.@.............
...@....@....@.@.@.@..........
.....@..@..................@..
...@..@..@@..........@........
................@.....@.......
..................@...........
..............................
@.......@...@....@.....@......
..........@.................@.
...@@......@@...@......@......
..............................
..............................
..@...@.......................
.......@........@........@....
....@.@.....@..........@...@..
...........@......@...........
..@.....@..@.....@............
..........@..................@
............@@.......@........
....@..@................@.@...
......@....@................@.
