30,30
..........@...................
............@..@....@.......@.
...........................@..
@.....@......@@...@........@..
........@.................@.@.
.@..@.................@...@...
........@.....@.......@.......
.....@........@...............
..@..............@............
...@.......@.........@........
....@.................@.@.....
........................@..@..
.....@............@...........
.............@...............@
@@..@@..@.....@...............
...........@.........@........
.@....@...@...@..@............
.........@....................
........@...@...............@.
.........................@....
...........@...........@......
......@...........@..@........
..........................@...
....@........................@
..@.........@...@......@..@...
@.....@....@....@.....@.......
......@...@........@.....@....
.........@........@........@..
...................@..@.@.@...
.....@..@.............@@...@..
