30,30
..@......@@.....@.@...........
.......................@......
..@...........@@..............
....@........@.........@......
.@@..............@........@...
.............@.......@........
............@....@...@....@...
..@...@..................@@...
.......@....@....@@......@.@..
.........@...@....@..@........
....................@.........
.@.........@..@.....@.......@.
.........@.....@..@......@@..@
.@...........@................
......@..............@........
........@.@.........@.........
......................@.......
...........................@.@
...@.@..............@.........
..........................@...
....................@..@......
.......................@...@..
...............@....@....@....
.@.....@..........@....@......
........................@..@..
.......@.......@..............
@...@.@.....@................@
.........@..............@@....
..@@..........................
@.@................@..........
