30,30
................@.........@...
...@........@...........@.....
...@..@.......@...............
@.....@@..............@.......
.........@@...@......@.....@..
..............................
..@..........@......@...@.....
...................@.......@..
@...@..@@.....................
.....@...........@.....@@.....
@.@.@..@.....................@
..................@.........@.
..@...@.............@.........
.@.....@......................
.........@......@.@..@@......@
..........@.....@.......@.....
........................@.....
..................@@.....@....
.......@@........@............
............@................@
...@.....@..........@.....@...
.............@................
................@.............
..............@...............
..@...........@.......@.......
...........@...@...@..@.......
@.@..@.....@............@.....
.......@.@....................
........@.....................
@.@@...@....@........@....@...
