30,30
............................@.
.........@@..@.@..............
....@.......@..@....@.........
..............................
...........@.........@..@...@@
..@.@....@................@...
@.....@@.....@..........@.@...
..........@...@...............
.@...........@................
............@........@........
..@....@....@.................
...@..@..............@...@....
....@.@@..@............@......
.....@........................
........................@@@...
.......@.@...................@
..............................
......@..........@.....@.....@
.............@.....@.@....@...
.@.......@@...................
@......@.............@...@....
..............@......@........
....................@.........
.....@........@@....@.........
......@@.......@.....@...@....
.......@@..@@.................
...@...................@..@...
....@...........@.............
.......@.@.............@...@..
.@............................
