30,30
..........@.......@........@@.
...............@..@.....@.@...
...@..@........@@.............
...............@.......@......
...@...........@..............
..........@......@..@.........
........@..............@.....@
..@..................@@.......
@..@...@...................@..
.............@.....@@......@..
@...@......@.............@....
................@.............
..........@..@..@.............
.@......@....@..@..........@..
.................@@@..........
@................@...@.....@..
.@...................@........
...............@..@..@....@...
.....@@.....@.@...............
............@........@......@@
....................@.........
......@.....@....@.......@...@
..@.............@......@......
.......@....@.............@...
...........@..................
..............................
...@..........................
.@............................
..@..@.........@......@.@.....
.........@...@...............@
