30,30
@......@.......@@.@........@..
@...............@............@
..@...@@..@.....@..@.....@....
.......................@......
.@............@@..............
.....@.......@.@......@...@...
..............................
....................@..@......
...........@....@.............
.............@...............@
.........@..................@.
....@......@.@.......@........
.@@.........@........@.@......
.......@............@.......@.
...........@@...........@.....
.........@.....@..............
..@.........................@.
..........@...@......@...@@.@.
.............@@...............
..............................
........@..................@..
@...@........................@
.......@....@........@.@......
....@.......@..@..@...........
........@.....................
...........@.........@..@...@.
.............@........@.......
....@.@......@........@.......
..@...........................
@..@......@.@............@....
