30,30
.......@....@.............@...
...............@@........@....
...................@....@.....
..........@...........@.@.....
.................@@@.......@@.
............@@.@..............
..............................
..@..@.........@......@..@....
...@........@...@...@...@.....
.......@.....@.......@..@...@.
..........................@...
.......@...................@..
..............................
.................@............
..............................
.@..........@..@........@.....
..............................
..@......@.....@@.@.........@.
..........@@@.................
....@@........................
..@..@........................
.......@.@..............@.@...
@.......@.@......@.@......@...
.............@.......@..@..@..
.....@........@...@@..........
........@@......@.........@...
..............................
..@........@....@......@......
...@.....@...@............@...
...@@........@..@.........@...
