30,30
.@.................@@...@.....
....@..........@..........@.@.
.....@..@....@.......@...@....
.......@.......@......@.......
............@...........@.@.@.
...........@.....@............
...............@.@........@...
.....@......@@.@..............
........@......@.@..@.........
...............@.........@....
....@@...........@@....@......
...............@.......@.....@
.......@...@............@...@.
........@..@....@.....@.......
........@................@....
.@....@@......................
....................@.........
..@....@............@......@..
....@...............@.........
......@......@.@..@.@.........
.........@.......@.....@......
............................@.
...............@.....@........
..........@@...@..............
...@..........@.......@.......
..............................
......@......@........@.......
.....@........................
.......@...............@......
.@....@@..............@.......
