30,30
.@@@...@......@...............
...@.............@........@...
.@.....@...........@..........
.......@....@...@.@...@@......
@@........@...................
..@...........@.@...........@.
@.............................
@.......@@.......@...@@......@
...@........@.@..@............
...............@..............
...@.@..@...@.......@...@.....
..............@...........@...
.@@....@.............@........
...........................@..
................@..@...@.....@
......@.............@.......@.
@........@..@........@@.......
....@...@..@.................@
...............@....@.........
..............................
...@...@.....................@
...................@@.........
..@..............@.........@..
................@...@..@......
@.........................@...
.@...........................@
.........@....................
..............@...@....@......
..@..@........................
.........@....................
