30,30
..@....@.......@..............
................@..@........@.
.@@...........@............@@.
............@.@...@....@......
....@...........@...........@.
..............................
....@......@......@.........@.
@.........@@...............@..
...........@.........@.......@
.......@...@.......@..........
....@.........................
....................@.........
......@.......................
.......@.....................@
@..............@....@..@....@.
..............@...@..@@.......
@....@........................
.............@..............@.
.....@........................
....@......@......@...........
....@.@.........@..@..........
...@..........@.....@.........
...................@@.@....@..
.......@.....@.@....@..@@...@.
.....@......@@.......@..@.@...
@.....@...........@...........
.......@.@....................
.......@..........@...........
........@.................@..@
............@.@...............
