30,30
......@...........@...@.......
.................@...@......@.
.@@.......@...@.@@............
@.....@...........@...........
@.............@.@.............
.......@.............@....@...
..............@.@.............
....@..................@....@.
@...@...................@.....
@.@....@.......@........@....@
....................@.@.......
.......@..@..@....@.....@.....
......@..@....@......@....@...
..@...................@.....@.
.......@......................
..@.................@....@....
..........................@.@.
.................@.......@..@.
......@....@......@.....@.....
...@......................@..@
@.@...........................
....@.................@.....@.
@.@..@...........@...@........
...........@..................
..........@.@.................
.....@..................@.....
...........................@..
...........@@.................
.@..@..@.........@............
........@.....@...............
