30,30
......@..@....................
..........@........@...@......
....@..@.........@..@.........
...............@...........@..
......@.......................
..@........................@@.
...@.....@........@....@...@..
..............................
@..@....@.................@...
..............................
.@.............@........@.....
.........@.....@....@.........
@.@.....@.....@..............@
@...........@..@..............
..@.....@..@.......@...@......
...........@.......@......@...
..@.@.@....@..................
@....@...........@............
...@..@.......@...@.......@...
............@..@.@..@.......@.
..............................
...@...@...............@.....@
......@...@....@.........@....
..............................
@...@.........................
....@...............@....@....
.........@....................
..@.....@...@..@..@....@.@....
..............................
.....@.@.........@..@.....@..@
