30,30
...........@....@.@......@@...
....@.................@.......
.......................@......
....@..............@..@@......
..................@.@.....@...
...........@.@.@@.............
@@.....................@......
..........................@...
@.......@..........@......@...
..............@...............
.@.....@......@...@.......@...
...@.@..@................@....
.@.....@....@..@.............@
...@......@................@..
...................@.......@..
........@.......@.........@..@
..........@@.......@..........
..@.....@@..@..@..............
.@..........@.................
.............@................
..............................
.........@@...................
..........@....@........@.....
.......@..@.@.@...............
............@.......@.........
.......@...............@......
............@..........@......
..@...........@...............
.@......@.....@.@.@...........
@...@@....@@..............@...
