30,30
....@...............@@........
.@..@...@..........@@.........
...@@.....................@...
...........@.....@.......@....
.......@@..@..................
..................@@....@.@...
.....@........@..........@.@..
...............@.@......@.....
..............................
...................@...@.....@
..@.........@........@@.@@....
.......@......................
......@..........@............
.....@...@@...@.@@.@..........
...@.......................@..
.......@.........@....@.......
..........@@....@.@...........
......................@.......
.........@....@..............@
....@@..@@@..................@
.......................@......
...@.@@.....@...@..@..........
...................@.....@....
..@.....................@....@
...................@...@@.....
...................@..........
.....@..@.....@...@.........@.
.......@......................
.....................@@.......
..............................
