30,30
............@.................
........@..@.......@.@........
.............@.........@......
.@.........@................@.
..........@..@.@.....@.....@@.
..@..@...............@..@.....
...........................@@.
..........@...@@.......@......
..............@.@............@
......@.........@.............
..............@.........@..@@.
.............@..@...@@...@..@.
.@@.................@@......@.
...........@..................
.@...........@..............@.
..........@...@...@@........@.
............@......@...@...@..
...................@..........
..@................@..........
.......@...@....@.............
...........@.@...............@
....@........@................
..............@@.@............
......@...@@......@...........
..........................@@..
......@.................@.....
..................@...........
.....@.@............@........@
.......................@......
......@@...............@......
