30,30
......@.@.........@...........
@.....@.......@..............@
...............@@.@.......@...
.....@...........@............
..........@.....@@......@...@.
..............@.@.........@..@
......@...........@.@.........
....@...........@....@......@.
..@.........................@.
@..........@..@.@..........@..
..............................
..............................
..........@..............@.@..
@...............@...@.......@.
....................@.@@...@..
..@@...................@......
.....@@............@..........
....@............@........@.@.
.......@..@....@..@...........
@.@...@.......................
..@........@............@.....
....................@.......@.
....@.@.@..................@..
............................@.
@............@.....@.....@....
@.@....@.............@........
.............@................
.@..............@.............
...@..........................
........@@..@........@........
