30,30
@............@............@...
..@..@...........@.@..........
..........@....@..@...........
.@.@.........................@
...@@................@........
.@@........@.........@@.......
...@....@.....@@...@@.........
.........@..................@@
@...........@.@...@.@.........
.@..........@...........@.....
.@.........@................@@
....@.........................
.@.................@.....@....
.................@..@@........
...@....@.......@.@........@..
@.............@...............
...........@......@...........
..............................
..............@.....@....@....
.................@@.@..@......
.@..@.........................
...@.....@....................
.............@.........@......
......@....@@.................
.....@....................@...
..@....@......................
..............................
.@.........@.........@......@.
...........@...@....@@.@......
.........@.......@........@...
