30,30
....@....@......@@............
...@@...........@.............
.....@......................@.
.............@..@.......@.....
...@.........@................
...@...@.@.............@......
...........@....@.............
.....@...............@@...@...
...................@..........
..@........@@....@.@@.@.......
@...........@......@...@......
..@......@.....@.........@....
..................@...........
.......................@......
..@...@.....................@.
..............................
....@...........@.............
........@..@...@.............@
..@...........................
.................@............
...............@.@@@..@....@..
.@...@........................
...@.........@...@...........@
...@.@...@@.................@.
@........@..........@.@...@...
..........@........@....@.....
.....@.....@.....@.@..........
@.@...........................
..............................
....@..@..............@...@@.@
