30,30
...........@..................
.............@....@...........
.............@................
..............@...............
.@............................
@........@.........@..........
...............@..............
..........@...................
@...@.....@...@............@..
...................@.........@
.@...........................@
..@.............@.............
.......@..@.@..............@@.
...........@...@..........@...
............@.....@...........
@...@......@..@.@.............
.........@....................
....@....@..@@@...............
.............@..@...@.........
..@......@.@........@.@@.@....
..@........@@@.....@..........
....@..@...@..........@...@...
..........@.......@...........
..............................
......@...@@...........@......
.........@...................@
.@..@@........@...........@...
..........@....@.............@
.......@..@..@.@..........@.@@
@..........@...........@@.....
