30,30
....@@.....................@..
..............@...@......@....
.@.@...........@.@......@....@
.......................@......
..................@...........
@...............@.............
..@...........................
..............................
.@...@................@@......
....@.@....@......@.......@.@.
..............@.......@.......
@@..............@......@......
..........@............@......
.....................@.....@..
...............@........@.@...
@....................@.....@.@
................@........@....
.@...@......@..............@..
........................@.....
..........@......@......@.....
.@..@.@..@.@.@...@......@.....
..@...@.................@.....
.....................@..@.....
.@@.@.........................
@....@.@............@.......@.
.@...........................@
........@...@..........@....@.
.@...........@................
@......@...........@.........@
....@.........@..@............
