30,30
@@...........@.@@.....@.......
.@..............@.............
.....@..........@..@.....@@...
.@......@..@...@..............
........@........@@...........
@...........@............@@...
..........................@@..
.....@..........@.........@...
..........................@...
.....@..@@...@@..@.@..........
.................@............
.........................@....
.@......@@....................
....@.......@..........@...@..
..@..@..........@.............
...........@................@@
.................@..@.......@.
................@.......@@..@.
.........@.......@............
..........@@............@@...@
..............................
@...............@...@.........
....@..............@..@.......
.........@.@.@.@..@@....@.....
........@.@........@..........
............................@.
...@................@.........
...........@..........@.@.....
..............................
.........@.......@............
