30,30
@..............@@..........@..
.....@........@..............@
.....................@...@....
....@.....@..@................
..@...........@..@............
........@..@.................@
@......@..............@.@.....
...@...........@............@.
.............@...@............
.....@.....@@.@.....@.@.......
.......@.........@.@..@.......
.....@..........@.............
.............@........@..@@...
...............@..............
......@.@...@..@...@.........@
..................@...........
.@....@.......@..@............
....@..@........@............@
........@..............@@.....
@....@...........@.....@...@..
..............................
....................@@.@......
.....@......@......@.........@
.............@..........@.....
@...................@.........
..............@........@......
..............@@........@.....
..................@........@..
..........@...................
.@@..........@.........@......
