30,30
...@@.................@.@.....
.............@.....@..........
.........@...............@.@..
..............................
.......@.......@...@....@...@.
.............@.@..............
......................@..@....
..@........@@.........@@......
@@.@..@....@@............@...@
@..@...@........@..........@..
..................@.....@.....
.........@.@..................
........................@.@...
........@.@............@......
.................@..@......@..
.......................@...@@.
.......@......@.....@.........
.............@...........@@@..
.@....@.......................
.............................@
................@.......@.....
.@...................@...@@...
......@.......................
...........@....@.@.....@@.@..
..@...............@...........
.............@@.@@........@...
.........@....................
...................@..........
@................@........@..@
....@.......@........@........
