30,30
@..................@..@.......
....@@........................
.@.@@.......@...@...........@@
..............@...@.....@.....
.....@........@..@....@.......
.........@...@..........@@....
...........................@..
...@.....@..@.@............@..
.......@.@..@.................
@@.......@...............@....
......@.@.......@.............
.......@......................
...............@..............
.........@...@........@.@...@.
....@.........................
...........@...........@......
...............@..............
..................@.....@.....
..........@...................
..............................
......@..@.@..........@.@...@.
......@...@..........@....@...
.@.@...@...........@..........
...@..............@.@@.@......
..................@.....@.....
.......................@.....@
@............@.@........@...@.
.......@.....@...........@..@.
..............................
.@@..@...........@........@...
