30,30
...@..@.......................
..........@@........@.........
..........@..@........@..@....
.........@......@...........@.
@..@...@@..@..................
.............@................
...@......@..@................
..................@...@...@...
...........@..@.......@.......
..............@...............
......@...@.......@...@....@..
..............................
............@.................
@........@...@.@..............
..........@..@................
....................@.........
..@...........................
.......@@..@...@........@.....
......................@@.....@
@...@.........................
...........@@@............@...
.....@..@@...@...@..@..@...@..
...........@...........@......
.........@.......@......@.....
....@.....@@.@........@....@..
..........@..@................
.............@.......@........
...........................@..
........@....@.....@..@@....@.
.@....@...........@....@......
