30,30
............@..........@.....@
............@.................
@.....................@@.@.@..
......@.............@....@....
.........@....@.........@....@
.........@@........@..........
........@.......@.............
.......@...............@....@.
...@@......@..@..........@....
....@........@.@..............
...................@.........@
..............@...@.........@.
.............@..@..@.@........
..............................
..@...........@.........@...@.
........@.............@.@..@..
.@@........@..@...........@...
......................@.......
......@@.@@...................
...@..........................
.....@............@...........
....@................@.@.@..@.
......@....@...@.@@......@....
......@..@....................
...................@..........
......@@.................@@..@
@...@......................@..
..@.............@.............
.......................@....@.
.....@............@...........
