30,30
.......@.......@...@..........
..@..........@.........@...@..
...........................@@.
@...........@@................
..........@.@...........@.....
.........@..@....@............
.......@................@.....
......@.......................
..@@.......................@..
......@..@....................
........@.@...................
..@........@..........@.......
...@..@......................@
.....@...............@........
@...............@.@...........
..@@......@.............@.....
.....@........................
...@.....@....................
..................@.@.@..@....
..............@.....@.@...@@..
...........@........@@........
@..............@...@.........@
...........@.@....@...........
..................@.@......@.@
............@@................
......@.....@.@...@......@....
@.........@..................@
..........@@.......@.@...@....
................@...........@@
.......@................@@....
