30,30
...............@..@...........
...@.....@.............@.....@
..@.......................@..@
@@...........................@
.......................@...@..
.........@..................@.
@@..........@...............@.
@......@.....@...........@....
.............@...@...@....@..@
...........@.................@
...........@..................
....@.................@.@.....
.....@.............@@.@....@..
......@..........@...........@
@.............@..@.........@..
@....@................@.......
......@@....@...@.............
...@..........@.....@...@.....
................@@..........@.
@.......@........@............
.....................@.......@
@...@@.@......................
...................@.......@..
.....@@.......@.....@......@..
....@.............@..@@...@...
..............................
....................@....@....
...........................@..
@.......@.....................
...........@..........@...@...
