30,30
.........@.@................@.
.........@..@.........@.......
...........@...@...@.@........
....@........@....@@......@..@
.....@.............@........@.
..............................
.....@......@....@......@.....
...@@@...........@.@.@.@......
.....@.........@@...@.........
.............@..@....@........
.....@.....@............@...@.
..@..........@................
@....@..@.@.........@.......@@
..............@............@..
..@................@..........
...@.........@...............@
.............@..........@.....
....@............@............
.@@................@..........
.....@........................
.......@.@@..............@....
.....@..............@.@.......
..........................@...
...@..........................
......@..............@.......@
..............@.......@.......
..@@..........................
...@.......@..................
..................@.@.......@.
.......@...........@..@.....@.
