30,30
..@...@................@.@....
.........@............@...@...
.......................@...@..
.............@....@...........
.........@....................
@.....@....@...@..............
.......@......................
......@............@.@........
@.....@.............@....@....
...............@...@@......@..
...........@................@@
........................@...@.
.............@......@.@..@....
.........@...@@....@@.....@...
...@.................@........
..........................@...
@..............@...@.........@
.......@............@.........
...@................@...@@....
...@.........@.............@@.
...................@..@@......
..@.@......@.@.........@..@..@
...@...............@.@........
...@.......@@.......@..@......
.........@......@.......@.....
.......................@......
.........@............@.......
...........................@..
.......@..............@...@...
.........@.........@..........
