30,30
...........@.............@....
...@@................@......@@
...........................@..
......@..@@..@.........@......
.......@..@...@...............
..............@..........@....
........@....@...........@....
...............@.............@
...@@.....@...@@..............
........@..........@..@@......
.@..........@@....@......@.@..
.....@.........@...........@..
.............@...@.......@....
.....................@.@......
.........................@@...
..........@...@..............@
@.....@.....@......@.....@@...
.....@@.........@@............
@............................@
......................@.......
...................@....@.....
@........@.......@..@.........
........@.....................
......@..@............@..@....
@..............@..@.@...@.....
...........................@..
..@.......@...................
...@.......@..................
................@.............
...........@....@.......@...@.
