30,30
............@..@..@...@....@..
......@.......@...............
..........@.......@.....@.....
.................@@...........
.......@.......@...........@..
...@..@...@...........@@....@.
.................@............
.................@............
.....@..............@......@..
...............@..........@@@.
...@..........................
............................@.
..................@@........@.
............@.................
.................@.@..........
.@................@..@........
.................@..@......@.@
....@@........@..@....@....@@.
.............@...........@....
...@.......@..................
......@@....@..........@......
...@...@@........@............
........@@....@..........@....
.@..........@@.....@@.......@.
.@...@@.......................
.......@..................@.@.
.....@........................
.............@................
......@.......................
.@@....@..@...@......@@.......
