30,30
...@....@...........@.........
...........@................@@
................@.............
.....@........................
..........................@.@.
@@...@...........@...@........
...................@.........@
@..................@@.........
.............@..@.............
...@..@......@@.........@.....
..................@@.@........
..................@...........
........@..@.......@..........
@..@....@@....................
.......@...@.@..@........@....
@...........@.................
...........@..........@......@
@.......@.......@..@@..@..@...
@......@..@@@...@.....@.....@@
......@@.@..@....@@@..........
..........@..........@.@.@....
.............@....@.@.........
........................@.....
......@.......................
....@.@.....@.................
..............................
........................@.....
...@..........................
@.............................
.....@...............@.@....@.
