30,30
......@........@..............
..............@....@.........@
.......................@......
......@............@..........
..@.....@................@....
..............................
@.........................@...
...@.@...@......@.@........@..
........@.......@...........@@
........@.................@...
............@.................
.............................@
@..................@..@@......
.......................@@.....
..@...........................
@..........@...........@....@.
....@...@........@......@.....
.......@@..@.@..@....@........
.@.@...@......@...............
.......@......................
..@.....@....................@
........@@....................
.@@.............@............@
.@............................
...............@..@.@.@@.....@
.......................@...@..
.....@....@......@.......@....
.........@..@....@.....@......
..@...@.......@.........@..@@.
@.....@@.......@.............@
