30,30
...............@..........@...
.@........................@...
.............@..@..@..........
................@........@....
.........@@..........@..@.@...
@...................@........@
.@..@............@..........@@
....@.........................
.....@........@..............@
.............@....@...@.......
..............@..@............
..................@...........
....@..@..........@..........@
.......@@.............@..@@@..
...@..@...............@.......
..............@...............
.@@..........@..@......@......
......@......@........@.......
...@....@@.............@......
.........@........@..........@
..........@...................
...@@.....@...................
........@....@.@.@............
.........@..@@@....@..........
@....@@...........@...........
.@............................
.........@....................
....@....@.............@.....@
.......@.......@...........@..
.....@...@........@...........
