30,30
..............................
...@....................@.@...
.......@......@........@......
@@.@@.@......@................
..............@.....@.........
...@..@.@.....................
......@.....@......@@.........
.........@.@...............@..
@...@........@.......@.....@..
.........@....................
.................@.......@....
....................@@....@...
....@.....@.......@...........
......@.......................
......@.@...............@.....
...........@..................
........................@.....
.....@@.@...............@.....
........@...............@.....
.@...@....@...................
.......@........@........@....
@.........@@............@..@@.
.@..@.@.@....@...........@....
...........@.@.@..............
..@...........@....@..........
.........@.....@..@.....@....@
..............@.....@...@.....
.........@.....@..............
.@...............@........@...
...........@@..............@..
