30,30
.@............................
.@.......@....................
....@........@..@...........@.
..@..........@..@.............
......................@@.@....
..@......@....@...@...........
@.............................
...............@..............
......@..@.........@...@......
.@..............@......@....@.
.............@............@...
...@..............@.....@..@..
..@.@..............@..@.@.@...
..............................
............@...@.............
......................@.......
.@.................@......@...
.@.........@...............@..
...@@.........@..@............
...@.@......@.........@.....@.
..........@.......@.@.........
@........@....................
.............@........@.......
.............@......@.........
@...@.....@....@..@....@@.....
@................@............
..@........@..@...............
.....@@................@....@.
............@........@.......@
..@........@.....@..@......@..
