30,30
.@@........@.@.......@@....@..
.....@.@.@@..@................
.@.........@.@..........@.....
@.............................
..............................
...@.@...@@.......@.@.........
.........@.@.........@..@.....
..@.@.......@.....@......@....
...................@........@.
.....@.@....@@............@...
.............@...........@....
....@............@@...@.......
..............................
.......@...@................@.
...@...@......................
.....@........................
........@....................@
@....@......@...@@............
.....@@...............@..@....
.......@...@.@.........@......
..@..........@....@...........
.@..@.@............@..........
...@.......................@..
...........@..................
.......@............@.@.......
@............................@
...........@..................
......@.......................
.@...@...@.........@..@.......
.....@.........@..............
