30,30
.......@....................@.
..@..................@.....@..
....@.@....................@.@
...................@.....@...@
.........@@..@................
.@....................@....@..
...@..@....@..................
.....@........................
..........@@.........@......@.
...@..@....@....@.............
@.@.....@@....@.......@.@....@
.......@....@.................
...........................@..
................@..@..........
................@...@.........
..........@...@...............
...@........@....@............
...........@.@.......@........
.@............@.@.@..........@
..............@...............
..............................
.........@........@@...@..@...
..@.@.....@........@.......@..
..............................
...............@......@.......
......@......@.....@..@.@.....
.....@..........@.............
@@.....................@......
......@.......@....@.@........
@..@...............@..@@......
