30,30
....@.@.....@.@...........@...
................@@.......@....
....@..................@......
...............@..@.......@...
.........@....@..@.@....@.....
..........@...................
......@.....@..@.......@......
@........................@@...
@.....@..............@....@...
...@.@.....@..........@.......
...................@..........
.........@...............@.@@.
......................@@......
..............................
.......@..@......@........@...
..............@.......@@......
...........@....@..........@..
.....@.....@..................
........@.........@.........@.
......@......@.@......@.......
........................@.....
...........@....@...........@.
............@........@......@.
.........@.@..........@.......
.........@............@.......
....@..@...@.............@....
.@...........@........@....@..
.....@@.........@..@....@.....
....@........@................
...@........@............@....
