30,30
..............@...@...@.......
@.....................@.......
.............@@..........@..@.
.........................@....
.....@@............@.@@.....@.
.@............................
..@..........@..........@....@
..........@..@.............@.@
....@@........................
..@.....@.....@...............
.................@..........@.
.........@....................
............................@.
.....@.......................@
......................@@......
..@...@...................@...
..........................@...
..............@.@...@..@......
@...@..@...................@..
...@....@...........@......@.@
..@..........@......@........@
............@...@..@..@.......
......@............@......@...
.......@@......@.....@@.......
.@....@....@..................
........@............@.....@..
................@.............
....................@.........
@.........@.....@@.@..@.@...@.
...@...............@.......@..
