30,30
.................@...@........
.........@...@.@..............
..............................
...@.........................@
........@...@.@.........@....@
......................@...@...
..........@@................@.
.@.@@.........................
......@...@...................
........@....@..........@.....
@....@................@.....@.
....@...@.......@.............
.........@............@.......
..............@..........@....
@.@.............@........@...@
....@@......@@.......@........
..................@....@.....@
......@@...@..........@.......
.@..@..............@..........
..................@.....@...@.
................@..........@..
......@............@..........
.....@..@..@..................
.......@......@....@..@@......
....@.@.......@...........@@..
........@@.@@..............@..
............................@.
......@.....@.................
.@..@.......@...............@.
.@...........................@
