30,30
.................@.......@....
........@...............@.....
.....@..............@.........
@........@.@.@.....@@.......@.
.....@.......................@
..............................
@..@@@@.@..........@......@.@.
......@......@....@...........
.@....@.........@.@....@......
..........@............@......
.....@...................@....
..@.@......@........@.@.@.....
.........@@...................
.....................@........
..............@.@..........@..
................@...@.........
..@....@.@....................
@............@..@....@.....@..
.........@.......@.........@.@
..@........@...........@.....@
@....@........................
..............................
............@.@........@......
.@...@........................
@.@....@@...........@.........
..@....@..............@.@.....
......@..................@....
............................@.
..@.......@....@....@...@.....
..............................
