30,30
..........@.@.@...............
................@...........@.
.@............................
.....@.......@............@@..
.............@@.........@.....
...@@.........@.........@.....
...@.........@.@..............
.......@........@.@.......@..@
......@.....@..@..............
.....@...@..........@.........
..@.....@..@...@..............
................@.............
.....................@......@.
...............@..............
............@........@........
@....@..@......@..............
.@...@...@...................@
......@.@..............@......
...@............@..@..@.......
....@..@...@..@.@.......@.....
.............@............@...
.......@......................
............@@@..@............
..................@...........
.....................@..@.....
........................@.@.@.
...........@...@..@...........
..............@.....@.........
........@...........@.@.......
@......@.....@....@.@@.....@..
