30,30
..@.....@@......@.............
..@.@...@@@...................
......................@.......
@............@.......@........
...@@.........@......@@.......
.......@.................@....
@.........@........@..@....@.@
...@..@.....@.....@...@.......
..@.@.........................
..............................
.....@............@......@....
..@.@.........@...........@...
.......@........@.......@.....
....@....@........@...........
...@..............@@..........
.@................@@.........@
.....@....@.....@...@......@..
...@.......@..@........@......
...@.@...........@..@.@...@...
.....@.....@....@........@...@
..............................
@...................@.........
..@..................@........
.....@................@.......
...................@..........
........................@.....
@....@........................
.@..............@.............
....@....................@.@..
...@...@......................
