30,30
....................@..@......
...@@...........@@..........@@
...................@..........
........@..@.......@@......@..
.@............................
.@.................@.@.@......
...@......@@..................
..@...........................
.....@..................@.....
....@.........@..............@
@.......@....@.@.........@....
.......................@.....@
@..@.....@.....@..............
.........@....................
@......@.......@........@.....
@....@@................@......
......@................@......
....@........@@........@.....@
@.....@.@...........@...@....@
......@..@.@.....@.....@......
.........@..............@.@...
.......................@..@...
....................@.........
..........................@...
........@...@..............@..
..........@.........@...@..@..
..............@..........@.@..
............@...........@.....
.@......@.....................
................@@.@..........
