30,30
..@@......@.@..............@..
....@...........@........@....
.......@..........@....@...@@.
......@...@..................@
......@............@...@......
...@..........................
.@...@........................
.....@.......@.........@......
...............@......@....@..
............@.................
@.@..............@............
.......@..@..........@........
...............@..@@..........
...@@..@......@..@.......@...@
.....@...@...@......@.@.....@.
..........@@..................
..........@.....@.....@.......
.......@@.....................
.@........@.@..............@..
.......@.............@...@....
.....@........................
....@...........@...@.........
....@..........@.@............
...........@..................
...............@..@.......@...
.@.......@.@.@@.@.............
......@.......................
...........................@..
...@......@............@@.....
.....................@.......@
