30,30
............@....@@...........
.........@.........@..........
..............@...............
...........@.......@@......@..
...@.................@.....@..
.....@..@............@....@.@@
@....@...@........@....@......
.........@@.......@...........
....@.......@...............@.
..@@...............@....@.....
...........................@@.
...@....@.....................
@.@......................@..@.
...@..........................
..@...@.@.........@...........
.................@@........@..
.............@..@......@...@..
..@.......@.......@.@@.....@..
........@..@..................
@.........................@...
....@............@............
...............@.@.......@....
.........@@@..................
.......@@.....................
....@.......@.................
..@.@.........................
@@........................@.@.
@.......@....................@
......@.@.....................
...................@........@@
