30,30
......@......@..........@.@...
..@........@..................
@.@@..@..........@...@........
..@.......................@.@.
...@......@......@.........@..
...@...@......................
........@...@.................
........@.@@.................@
............@...........@@....
.@..@....................@....
.........@....................
..........@...@...........@...
....@........................@
..............@@..@...........
.........................@....
.....@........@.........@.@@..
............@......@..........
.......@.@.....@..@.....@.....
..@........@@...@...........@.
.......@........@.............
..............@...............
..@.......@......@............
..................@...@.......
....@...@.......@.............
...@......@...@.@..@......@..@
.@............@............@..
......................@@.....@
....................@.........
...................@....@.....
........@........@.@..........
