30,30
.........@............@.......
....@@.........@..@...........
.......................@..@@..
...@........@...........@.@...
.....@..........@..@..........
......@..........@............
........@.@...................
..............................
.@......@.....@....@.@........
......@.....@....@........@...
.....................@........
......@.......................
.......@..........@...........
......@..............@........
...................@@.........
@.......................@@.@..
........................@.....
.................@.@....@.....
.@.......@@...@.@@.@......@...
.@.........@.......@.......@..
.@..@........@...........@....
.....@.....@.......@..........
.....@....@................@..
..@..........@...@............
...@...@@.......@@....@..@.@..
.............................@
........@...@.@...............
............@@.....@..........
...............@...........@..
..@....@.@....................
