30,30
...@....@..@.....@............
....@.........................
.....@..@.@..........@........
.@......@...........@....@....
..@............@.......@......
......@.@.....@.....@@....@...
@..................@........@.
..........@..@....@...........
.........@.............@@.....
............@@.............@..
...@..........................
@@............................
.........@@...................
............@..@..............
.............................@
..@....................@.@@.@.
@.................@.......@...
.@......@..................@..
.@..@...............@.........
........@.....@.......@.....@.
...@....@..............@..@...
..@..@........................
...@......@.....@....@.@...@..
.........@.......@.@....@.....
@....................@........
....@.........................
..............................
......@...@..............@..@.
.@.....@...@.@.............@..
..................@......@....
