30,30
.................@..@.......@.
......................@.......
..@.......@.....@...........@.
.....@.@...........@@...@.....
...@@.........................
..............@....@..........
.@.....@....@...@........@..@.
.....@........................
........@@............@......@
.......@......@.......@..@....
..............................
@............@..@.............
.....................@......@.
.........@........@..@..@.....
@..........@................@.
.................@.........@.@
.....@..@.@.@@..........@@....
.......................@.....@
@...........@........@........
..............................
..@...........................
.....@..@..@...............@..
..@.@........@........@.......
@........@........@.........@.
.....@............@...........
.................@.....@......
.......@@.....................
........@.@...@...............
..@..............@.........@..
...@@...............@@....@@..
