30,30
......................@.@.....
............@....@..@........@
................@.............
..............@...............
...@........@.......@......@@.
.....................@........
..........@...................
@..@..........................
...........@............@.....
........@..........@..........
........................@..@..
..............@......@.@....@.
..............@...@.......@@..
.............@@.@...........@.
@..@.@.@@....@...............@
..................@...@......@
......@..@@@..................
..@....@....@...@.............
.......@...@....@.............
...@...@.................@....
...............@...@@.@.......
.@..................@..@....@.
............@.......@.........
.........@.@.@............@...
.........@..........@.@.......
..@......@............@.@@@...
.........@.@.................@
.....................@........
..............................
..@.@............@.@..........
