30,30
...@@...............@........@
@..................@..........
..........@..............@@...
............@.................
.........@..........@.........
@.......@....@...............@
...............@...........@@.
...................@.@........
.@......@..........@..@.......
@.......@...........@...@.....
...............@.....@@.......
........@...@....@..@........@
..................@....@...@..
...@....@.@...............@...
....@@..@.......@.........@...
.@....................@.......
....@.@...@......@....@...@@..
...@..............@...........
..............@...............
...@.....@.......@............
......@.@.....................
......@...........@...........
..............@....@@.....@...
...........@..................
...@....@.....................
...........@..@.........@.....
.@.........................@..
...@.@@....@........@.........
.....@................@..@....
..........................@..@
