30,30
.....@...........@.......@....
...@...........@..............
......@.......@......@........
.....@.....@................@.
...@.@.........@....@.........
............@.................
....@..@..........@......@@@.@
.....@....@...........@@..@...
.....@@.......@..........@@...
...@.......................@..
.@...........................@
......@.....@...@.@...........
...@...@..............@..@.@..
....@.........................
..................@....@......
............@............@....
..............................
@....@@.......................
......@..@.....@........@....@
.........@............@.......
......................@.......
.......@...@..................
..@.@...@............@........
@..........@......@.........@.
.........@.................@..
.........@@...@...@....@......
.........@.@....@......@......
...................@.....@....
..................@..@........
.@.....@.@....................
