30,30
.......@....@......@...@......
....@...........@@...........@
...........@............@.....
...@...............@..........
.....@..............@.........
.......@.......@...@..........
@@..............@@.@..@@......
@....@.@.@................@@..
..@....@.......@..............
.....@.@@......@...........@@.
......@.......................
...............@..@...@.......
..............................
@.@.........@.@....@@.....@...
.......@..@..........@.....@..
.......@...................@..
...@..................@......@
.........@.........@....@.....
........@@................@...
..................@.......@...
.......................@@.....
.............@.......@.......@
..@.......@.......@..@......@.
.........@............@.......
........@...............@...@.
......................@@......
.......@..@.@.................
..............................
..@.....@.....................
.........................@....
