30,30
..@.@...@.......@@.....@......
.........................@....
.@.....@......................
....@.................@...@.@.
..........@..@@...............
........@.....................
..........@...................
.@..@........@...............@
.........@..@...@.........@...
@.............................
....@.....@...@...........@...
.........@..@...@....@...@....
........@....@@..@.......@....
..@.@@.....@.....@............
....................@.........
..@.@@..@.@.@@..............@@
......@...........@....@...@..
.........@......@.........@...
..................@.....@.....
.....@......@.................
................@....@...@....
.....@........................
...@......@........@@.........
.......@....@...........@.....
..............................
.........................@....
.@........@...@............@..
....................@...@.....
.....@...@......@@............
.............................@
