30,30
..........@....@..............
...@..........................
@....@........................
...............@..............
@.........@.@.@...............
.......@.@.............@......
..............@..........@.@..
..............................
...@...................@@.....
........@.............@.....@.
@..@.....@...@......@@@..@....
..........@...........@...@...
.......@.@...................@
.............@....@.@.........
.@...................@........
..@.................@..@......
..............@...........@...
@..........@..................
...@........@.@...........@...
......@@..........@.......@...
........@................@..@.
...@.@.@@.....................
..@.......@.............@.@...
.@..@...@...@.....@.......@..@
@..............@..............
......@...................@@..
...@..........@............@..
...@....@......@..............
.@.@..............@...........
..............@.@.............
