30,30
.........@@..@...@.....@......
.........@......@........@.@..
.....@...........@...@@...@...
.....@@.........@.............
.@.........@......@..@.......@
.....@..................@.....
@........@......@.............
.......@......................
..@......@....@..............@
...............@..............
..........................@...
...............@............@.
...................@.@@@......
.@......@......@@.............
.................@.....@...@..
.@...................@.@......
................@@.@.......@@.
.@@...@.....................@.
........@..........@..........
.@.........@..................
..@..................@........
..............@@.....@........
.@...@......@....@.@.........@
..........@.........@.........
....................@.........
.............@.........@......
..@@..........@.............@.
...@.................@........
..@.......@............@......
...............@......@.......
