30,30
......@.......@..........@....
......@.@..........@.........@
....@.@.................@.....
................@..........@..
.@.......................@.@..
..............................
@......................@..@@..
..@..@............@...........
.......@.@.....@......@.......
...@@..........@..............
........................@...@.
...@..................@@...@..
.@.....@@@.....@...@....@.....
..............................
.@.........@@.................
......@.....................@.
.................@@...........
..........@.@............@....
...@....@.....@........@.@....
..@.........@.@..........@.@..
....................@.........
.....@........@........@......
...@......@..@....@....@......
@........@....................
......@........@.........@@...
@.............................
...@..........................
....@..............@..@.......
..@..........................@
.@@..........@....@.....@..@..
