30,30
.....@....@.........@..@.....@
....@...@..............@......
.@......@....@.@.@............
.......................@......
..@@....@...@......@.....@....
@.......@.....@............@..
.@@.....@............@.....@..
...@.....@@...@.....@.........
...@.....@.......@..........@.
..................@...........
.......@......................
..@..................@@.......
..............................
..@........@...@....@@.....@..
.@.............@..............
....@...........@@............
............@..........@....@.
.........@....................
...@........@...@.@..@........
.....@..................@..@..
...................@....@.....
..@........@...@.......@......
.@......@..........@..........
@.@..@.@....@.................
.......................@......
......................@.......
..............................
..@@......@.@...............@.
..@...........@...............
............@.................
