30,30
.......@.@...................@
....@................@.@..@...
@@.@..........................
......@.......................
..@......................@..@.
@.........................@...
.....@............@..@@...@...
..@.......@...................
..@........@..................
.........@.....@............@.
......................@.......
....@......@.............@....
...@...@..@...................
.@.................@..........
.......@.@...@.@...@@...@.....
..........@...................
.....@..........@............@
..@....@......@...@....@......
....@@....@...................
.......@..@.............@..@..
@.............@...........@...
...@.....@....................
..............................
.@............@...............
................@....@.......@
..@..@.....@.......@.......@@@
.@.....@..@..............@.@..
..............@...@.....@....@
...................@..........
........@...@...........@.....
