30,30
@.............@..@............
............@.@..@............
....@..@@...........@........@
.........@.....@@@.@.@....@...
.......@........@.@....@...@..
.........@....................
................@........@....
@........@...........@........
....@..@.@..........@@.@......
..............................
.......@....@............@...@
......@.@..@....@.............
@.......@...@.................
.@............@.@....@....@...
........@...................@.
..............................
..............................
...@.....@.......@@..........@
.............@...............@
.....@........@..@.@..........
.............@@...........@...
...........................@..
.@@......................@....
..........@......@............
@...................@.........
.@............................
..@@...@......@...............
......@.....@.........@..@...@
..@.@....@....................
....@.........@...............
