30,30
.................@....@......@
....@@..@..@..............@...
..........@............@......
....@........................@
@@........@.......@.......@...
..........................@..@
......@.............@.........
....@.@.......@@......@.......
@.....@....@...@.....@........
.......@..........@@.@.@......
....@..@......................
............@........@...@....
...@...........@...@....@....@
.@.@.@........@...............
...............@..............
................@......@..@...
@@.@..@............@...@......
.@.@.............@....@.......
.............@...@.@.@....@...
.....@.............@......@...
.......@......................
.@@......................@....
..............................
.@............@...............
.....@@..........@............
....@.@.@.............@.......
..............................
............................@.
.......@....@.................
.......@............@.........
