30,30
..@...@....@.....@.....@......
.......@...........@.@..@.....
.....................@.....@..
......@.................@.....
.....................@........
......................@.......
.......@..........@.@.@.......
.............@............@..@
.................@....@.......
..........@.............@.....
..............@..@.....@..@...
..........@.@..@..@...........
...@@.............@........@..
......@@...@....@..........@..
........@.....@........@@.@...
.@...........@................
...@..@...................@...
......@.............@....@....
......@...@.........@.........
.................@@.....@.....
......................@.@.....
..@.....@....................@
..............@........@...@..
............@..@.......@....@@
..................@@@.........
..@....................@......
..............................
.....@...................@....
@.@.......@...@..@............
...@....@.........@...........
