30,30
..@...........................
.........@............@@...@..
........................@....@
...@..........................
@.......@.....................
...........@..................
...@..........@...........@...
.@..@.......................@.
........@.......@...........@.
.@..........@.@............@..
...........@............@.....
....@..@...@..........@....@..
..........@@@...........@.....
.......@.................@@...
..@...........@...............
@....................@........
............@..........@...@..
..@................@...@.@....
...@......@..@...@....@......@
@..............@............@.
.....@..............@.......@.
..@.............@.............
@....................@........
@....@.......@..........@..@.@
..@@................@..@..@...
@@.............@...@..........
.........@..........@...@.....
...............@..............
........@.......@.............
.......@..@.........@....@....
