30,30
.....@...........@...@........
................@..........@..
.....@.@@..................@..
@.........@.......@......@....
............@.@...............
...@@.........................
..@............@..............
.........@...........@...@....
.................@.@..........
...........................@..
....................@.........
......@...@............@......
................@......@......
........................@.....
...........@........@.@....@..
.@.@...@@...........@...@.....
@....@........................
............@.....@...........
..................@.......@...
..@...@@.@.........@.........@
..............@....@..@.......
@........@..........@.........
.....................@........
.........@.....@..............
@....@..........@.@.....@.....
..@.@.@.......@.@............@
...@....@..@..@...........@@..
......................@.....@.
@.@......@.....@...@..........
..........@.@.......@.........
