30,30
...........................@..
.@.@..@.............@.....@...
....@@..@.....................
..........@.............@..@..
..@...........................
........@.....@@.@.........@..
..@.@...@.@...@.............@@
.@...@.......@................
..............................
................@.............
..@................@@.....@...
.@.....@........@.@...........
..@@....@.@....@........@.....
......@.@...................@.
..............................
@..@..@.@........@...........@
.......@...@..................
............@......@.......@.@
.............@...@.........@@.
..........@...................
.@.@..........@...............
....@....@............@....@..
........@...........@..@......
....................@.@.@...@.
......@...@@...@......@...@...
........................@.....
..@...................@.......
.....@.......................@
..............................
....@..................@......
