30,30
@..........@.........@........
@.@....@.@........@...@.......
@.....@.......................
.......................@......
...........@..................
........@@....................
...@...@........@.....@.@.....
..............................
..@@................@......@@.
.....................@........
..............@...............
............@......@.......@..
..........@.....@.@.@.@....@@.
..............................
..............@@..........@...
.......@..............@.......
...............@..............
.....@..........@..........@..
..........@...@.......@.......
...........@..................
.@..........@.................
........@.........@...........
...@..@....@.....@............
...@.........@........@...@...
@..@............@.............
....@.................@.......
....@..........@......@@......
.@....@@............@.@@@...@.
.....@......@@@............@..
......@...........@@@..@..@...
