30,30
....@...@...@..@.....@.@......
.................@.@@@........
@.......@.....................
@....@.......@...@.@..........
...........@@.........@.......
...................@....@..@..
................@........@....
.........@...........@.......@
.........@@...@.@....@...@....
.........................@....
...@...@.............@.@......
....@....@.......@.......@....
................@.......@..@..
................@.............
......@@.......@......@.@.....
............@@................
......@....@....@.....@.....@.
@...............@.............
...........@.@.....@..........
@.....@......@.@....@..@......
....................@.........
.@............@...@...........
...............@@.............
..............@........@......
........@....@................
..@........@@..@............@.
........................@....@
..............@...............
....................@.........
......@.......................
