30,30
..@............@@.............
...@...................@......
......@.....@.@........@......
.@.@........@.......@.........
..@.............@....@.@......
@.....@........@....@.....@...
......@.............@@........
.......................@....@.
...................@..........
.......@..@.....@.............
.......@.@....................
..@...............@...........
...@.............@...@...@@...
............@...............@.
.................@@.....@.....
@......@.......@..............
...........@@.................
@.......@........@............
......@......@@@..............
@@@......@..@.....@..@...@@...
............@...@.............
..........@...................
....@.@..@....................
.@............................
...@....@...................@.
.....................@........
...@.@................@....@..
.....@......................@@
..@@..@.....................@.
.......@....@.................
