30,30
.......@@............@@.......
........@........@.@@........@
....................@.........
@............................@
.......................@.@...@
.......@....@.................
..........@.@..@..@@....@..@..
.....@......@.................
.@.....................@.@....
............................@.
............@.........@.....@.
.@.@..........................
...........@..............@.@@
...@....@@....................
...........@........@@.....@@.
.....@........................
............@@.......@........
...@.@@..@@..........@....@@..
..........@...................
...................@@..@.@....
..@.@.@...........@...........
..............................
...............@.........@....
...@@..@...............@......
........@.....................
.....@.........@.......@@.....
..@...........@.....@.......@.
...................@...@......
...............@.......@.@....
....................@.@.......
