30,30
.......@.@..@.................
......@..........@......@.....
......@.......................
......@..@.........@@.@..@....
.....@..........@.@...@......@
@..................@.....@....
........................@.....
..............@@..............
........@@.@.....@.......@....
....@.........@...@....@.@....
..............................
......@..............@@@....@.
..............@...............
.....@..........@.............
.........@..............@.....
..............................
@....@.....@........@.........
..@...............@.....@.@@@.
....@.....@........@........@.
.....@.....@..................
...@.......@@...@.............
.......................@......
@...@.............@...@.......
@.............@..@............
..@.@...@............@........
.....@@..........@.....@..@.@.
..............@.@.........@...
....................@.........
..............@.......@.......
.........@......@.............
