30,30
..............@...............
.....................@........
@@.@.........@...........@.@..
.............@....@...........
@..@.............@.........@.@
...............@....@....@....
..........@.....@@............
...............@............@.
.........................@....
..............@@.@............
.......@...@..@......@@..@....
......................@@......
...@.@........................
................@........@....
...@...............@..........
........@.@...........@...@...
...@....@........@@......@....
....@........@.....@..........
.........@...@................
.........@.....@.......@.@..@.
....@..@@.....@....@....@.@.@@
........@...@..............@..
.....@......@....@.@..........
..@......@..@....@............
...@.....@.....@..............
.....@.........@..............
..............................
..@...........................
...........@..................
..........@..@...@............
