30,30
...................@..........
..................@..@........
....@..................@.....@
.................@............
.@.@..............@..@........
........@.....................
............@..............@..
..@....@@............@........
..........@......@.....@....@.
.............@.@..@...........
...................@...@.@....
...@..@...@@.............@....
.@....@..@....@.....@.........
................@.............
.........................@...@
.....@..@.....................
....@.............@.......@.@.
...................@..@@..@...
..@.@.........@..@@...........
...@.................@.......@
.@.@......@...................
..@@.......@..................
.@....@..................@....
..............................
.........@......@.........@@@.
@.............................
......@.......................
.......@...@........@....@....
...@........@..@.@..@@..@@....
@...........@............@....
