30,30
...@.......@@......@....@.....
......................@@..@.@.
..............@...............
.......@.............@........
...............@...@.@.@......
@.............@...............
....@.........................
..@@.......@................@.
..............@...............
........@...@.................
.....@........................
.@....@........@..@@..........
....@...@..@@.................
..............................
....@...@..........@.@........
..............................
@@..@........................@
.......@......................
....@....@.....@@@............
....@...@......@.......@......
.....@.......@..@...@........@
..@..........@................
.......@......@............@..
...............@..............
.@.......@......@....@..@@....
.............@................
......................@....@..
..@.@@....@.....@............@
...@...@.......@....@.........
....@..@.....@.@.......@...@..
