30,30
...................@......@...
.@.....@.@.@.........@........
............@............@@..@
........@.......@.............
...........@..........@.@.....
..............................
.@.@@.............@...........
........................@...@.
....@.....@..............@....
...@.............@....@......@
..@.......@.@@.@...@..........
@@...............@...@......@.
........@........@.....@......
...........@.....@............
..............................
@...@...............@........@
.....@..........@...........@.
............@@....@.@..@......
.................@............
.......................@......
......@..................@....
@...@.......@.....@.....@.....
....................@@......@.
...@........@......@..........
.............@..............@.
@...................@....@....
.........................@....
............@@................
.....@.@@@...@................
@....@..@.......@......@......
