30,30
......@.......................
..............................
@...@...........@.......@.....
..@@.....@..@...........@@....
..@........................@..
.....@..........@...@.........
.................@.........@..
..@.......@...@...............
.....@........................
@....................@@..@...@
.@.............@....@...@...@.
..............................
...@...........@..@...........
.@@.........@.@...............
.......@........@...@.........
...@..........................
.......@....@........@..@.....
..........................@...
...............@...@..........
.@.................@..@.......
...@.@@.....................@@
..@........@...@.@......@.....
...@..........@..@..@.........
...@.........................@
................@..........@..
@............@............@..@
...@@@..........@..........@..
......@..........@.....@......
.@.@........@..@.......@......
...........@.............@....
