30,30
.................@............
......@..@..........@.........
.@........@....@..@...........
.................@............
..@..........@................
..@..........................@
...............@.@...@........
.............@......@..@......
...@.............@.....@.....@
@.............@.@.@@....@.....
.......................@......
.....@..@.@........@..........
.......@...........@.......@..
......@.................@.....
...@@.@.............@@.@@.....
................@.............
..@.....@....@.......@........
..............@..@.....@......
@...............@.@...........
.@...@.....@...@..............
..........@@.....@...@........
......@..........@............
.........@......@.@.....@.....
...@..........@...............
.............@................
.....@....@......@@...@.......
.@@.....................@.@..@
....................@@........
.@............@..........@....
............@.................
