30,30
.@......................@..@@.
.......................@......
@.@..@...................@....
...........@.....@.@......@@..
..................@.@.........
............@...............@.
@.........@.................@.
....@.....................@...
@.........@.........@........@
...................@........@.
...@..@...........@...........
...................@.....@..@@
..........@.@@..........@.....
........@.....................
.@.@.....................@..@.
..@...@..@.........@...@@.....
..................@..........@
.....@............@...........
............@.@...............
......@.....@....@............
....@........@.........@..@...
.......@...@..@...............
..............@..........@....
...........@@.................
..............................
.@.............@.@.........@..
.@.@........@..@@...........@.
..........@...................
..@...@...@..@@..@............
.........@.............@......
