30,30
.@.......@........@...........
.......@@.@...................
.................@...........@
............@..............@..
..............................
.......@..@@@....@...@.......@
...@.............@.........@..
..@..@............@@..@.@.....
.............@................
.........@.............@..@.@.
@@........@...............@...
...@......@...@...............
..............................
@.....@........@...@...@@.....
..@.........................@.
................@.@..@@.@..@..
..@....@...@......@..@..@.....
....@............@..........@.
..............@..........@....
.......................@......
......................@.......
.............@.....@......@...
........@...@.........@.....@.
.@..........@........@@.......
...................@......@...
...........@.......@@...@.....
@.................@...........
............@..............@..
...............@..........@...
......@...@...................
