30,30
.................@@@..........
..............................
........@..@.....@...@@.......
@.....@.......@......@........
............................@.
....@....@@.........@@...@....
.............@...@............
.....@.@....@......@.....@....
.........................@....
...@....@@.....@@@........@.@.
..............................
.................@............
.....@.....@..@...............
@............@................
.@@...@.......................
....@......@.....@.........@..
@...@.........................
......@.....@........@........
...............@....@.........
..............@.............@.
...........@.................@
......@@@.....@...............
..............................
.................@....@@..@...
.....@...@.@..........@.......
@....@.@.@@@..................
.............@..............@.
...@........@.................
..............@...@.@@.....@..
.....@....@...@..@............
