30,30
..@.........@.............@..@
............@@..........@..@..
.................@@...........
.......................@.@..@.
............@.@...........@...
...@......@.@@..@.........@...
.....................@........
...@........@........@........
..@......@..........@.........
..@...........................
....@................@.@@.....
.@............................
.......................@......
.@........................@...
..........@.............@.....
...................@..........
..............................
@.....@..@...........@........
..........@....@...@@.........
....@...@@......@.@....@......
.@.........@..................
..........@.........@......@..
.............@.@..............
.......@...@..................
.......@...@....@...@...@..@..
..........@..@@.............@.
..............@...............
@....@..@...@...............@.
........@@...@..@.@...........
...@..@.....@..@......@.......
