30,30
.....@....@....@@.........@...
@.....@.@.....................
.............@......@.@.......
.........@.....@...........@..
................@........@....
....@.@.......................
.....................@.....@..
...@.@..................@.....
.......................@......
..@...........................
@......@..........@...@......@
.@......................@@....
......@.....@...@...@.........
...@..........................
..................@...........
...........@................@.
...@.............@...@........
..........@.....@.....@.......
.......@.@......@.@..@........
.....................@........
........@@@.......@@.......@..
....@....@@.................@@
..................@...........
.........@.......@.@....@.....
.........@..@......@.@.......@
.....@@......@.........@......
@...@.............@.....@@....
....................@.........
.@..@.........................
........@.........@..@..@.....
