30,30
...................@..........
.................@.@...@......
..@..@..............@.......@.
..........@....@...@.@........
..............................
@..........@..@@..............
.........@............@..@@..@
.@................@...@.......
......@.....@.................
.........@.............@.@....
.@.....@......................
.@....@........@............@.
.........@......@......@....@.
.....@............@..@........
@..............@.....@....@...
.................@........@...
.......@...............@......
.............@....@...........
.@.......................@....
.........@@.....@@........@...
@........@@............@......
..@..........@............@...
...@...@......@......@...@....
.....@........@..........@....
.@...@..............@.........
..@..............@............
@...........@.@..@...@...@....
..@@.@................@.......
..............................
..@...........................
