30,30
...@@..........@...........@..
........@..@.@................
....@.........................
...............@.........@....
..........@.....@.............
...............@.......@......
...@...@.......@..........@...
.@.........@......@..@....@...
.......@..@...................
...............@..............
.@............................
..........@...@.............@.
..@.................@....@....
...............@..........@...
.............@...............@
..@.@.......@........@..@.....
................@..@@...@....@
.....................@........
........@..@.@@...@@.@...@..@.
..................@..........@
..............................
....@...@...........@@......@.
..@.........@.................
....@..@.@..............@....@
.......@@............@....@...
.@................@.....@.@...
................@.@...........
....@.........................
....@.......................@.
........@.....@@@@..@.........
