30,30
.....@....@...@............@..
..@......@....................
..@.@@@.......@.....@.........
.....@............@...........
......@.@.@....@..............
......@........@.....@.....@..
.....@....@..............@..@.
.....@....@...................
@.@............@..............
..@........@@.................
..........................@...
.......@.........@.......@....
.@....@.....................@.
......@.........@.............
...........@............@.@...
..@.......@................@..
..@.......@.................@.
..@...@.........@.............
..@..@.@.................@....
..............................
............@................@
..............................
.@..................@......@..
@................@............
.....@..@..........@@.......@.
.....@...........@.@....@..@..
.@@........................@..
....@.........................
@.............@..........@@...
.........@.@...@......@.@....@
