30,30
........@@............@.......
.........@....@...............
.......@..@...................
@......@@@@@..................
....@....@..........@.@..@....
..........................@...
.@....................@.......
......@...........@.@.........
..............@@....@......@..
.............................@
..@.........@................@
.......@................@@....
..@........@........@...@....@
.................@@.......@...
...@..........................
....@......@.......@..........
........@...............@@....
.....@......@@.......@.....@..
....................@.........
..........@...........@..@....
....@.....................@...
@...................@.........
......@..@.@..........@..@.@..
@@.........@..@@..@...........
...............@..@.@.........
.............@..@..........@..
.............@...@............
....@.........................
.@.@....................@..@..
....................@......@..
