30,30
......@.................@.....
..................@..@......@.
...........@...@.............@
..............................
@.........@...@..........@....
...@@.@..........@...@.@......
....@.....@.........@...@@....
............@..@..@......@....
........@.....................
...@..........................
@..@............@.....@.@.....
..........@.........@..@......
........@......@..@...@.......
@....@........................
......@.@.@....@...........@..
....@........@..@.......@..@..
...@.@...@.........@..........
.......@.........@............
............@...@.............
...@.............@.......@.@..
.@.@.........................@
@.....@.@...@...............@.
.......@........@......@..@...
.......@.................@....
.....@......@@.....@.....@....
..@..........................@
.............................@
..............................
...........@...@..............
...........................@..
