30,30
............@................@
............@....@............
.@.............@.........@.@..
.........@.....@.........@.@..
..............@.@.............
.............................@
..@..................@.....@..
......@.@.....................
.....@..@..@............@.@...
..@.........@@@...............
.......................@...@..
......@..@......@..@..........
..@.@.......@.@.......@.@@@...
...........@.................@
..............@........@......
....@........@................
.......@..@@....@.............
.........@...................@
.@....@..@................@...
.........@...........@......@.
.@.........@...@@....@.@...@..
...............@.............@
..........@..............@....
...........@...............@..
.@....................@...@@..
.@@...........................
....................@........@
..............................
........@...@.........@.......
.........@@@.....@............
