30,30
@............@@.....@.@.......
........@@............@.......
.....@.....@.................@
.@.......@.......@@.....@.....
......@............@..........
........@.....................
......................@.......
.@....@.......................
...@.@............@...........
.@.....@@........@......@....@
@.@.....@...@.@...............
..@...........@@...@..........
@.............................
.............@............@...
....@.@.............@.......@.
@.........@...............@..@
..@...........................
@....@........................
@..........@..................
.@.......@..................@@
.....@.........@.@..@.........
..@...........................
@..............@....@.........
..............................
.@.....@....@........@........
.............@...@.@.@........
.....@.....@..@.@.............
.................@..@.....@...
@..........@..............@...
.....@...@.............@....@.
