30,30
..................@.........@.
..@................@......@...
......@......@................
.....................@@..@.@.@
.............@.@....@.........
......@.@.@...@.@@............
@@............................
..@......@.@.......@..........
.....@........................
....@..@@.........@...@.......
............@.@......@........
.......@.@....@..@.........@@.
............................@.
....@............@.......@....
............@..@............@.
..............@..........@..@.
........................@.....
.......@...@......@...........
.@.........@......@...........
...@....................@.....
.......@............@..@......
.....@...............@.@.@...@
.............@..@.............
.............@................
...........................@.@
.@........@...........@.......
@.@...........@...............
....................@.........
.......@@..........@....@....@
..@.......@.@......@..........
