30,30
...............@..............
...........@.....@.......@....
...@..@.......................
......@.....@.................
@@....@.......................
......@.@........@......@.....
..@...@.....@.................
..@....@..............@@....@@
.......@............@.@.......
.............@........@.......
......@.......................
@.............................
....@.@....@...@...@..........
.....@...@....@.....@.@..@....
.....@.........@.........@...@
....@..@....@.................
...............@..............
..............................
.....................@..@...@.
...@..........................
@@........@...................
...........@@..@..@@...@......
...@........@...............@.
.................@..@....@....
.@.........@......@...........
@.....@....@......@...........
..@....@......@@.@............
........@.............@..@....
..............@@.....@........
..@.@...................@.....
