30,30
.........@....................
...@....@...@..@............@.
..@............@.......@......
@..@...........@@.............
........@...............@.....
.@.@.@.......@......@.........
.........@..............@.@...
......@...........@..@........
..@......@...@@...............
..............................
.......................@......
@....@...@.@............@.....
.......@..@.....@............@
....@.......@..@@...@....@....
...........................@..
....@.@.........@.@...........
...........@...........@.@....
.......@......................
....@......@..@..........@....
.@.@....@............@.@......
...........@......@..........@
...........@......@......@.@..
..................@.......@...
............@..@.....@........
...@........................@.
................@@............
...............@.......@.@....
..................@...@@......
..................@...........
.......@...@..@...............
