30,30
............@...@.@@..........
..@@..@...........@....@......
....@.........................
...@..@................@......
.@..@.......................@.
..@................@.@........
...@....@.......@.@...........
..............................
.@@.............@.....@......@
..................@...........
....@@...........@.....@......
.....@..........@.............
.......................@....@.
...................@.......@..
@..@...................@.@....
......@....@..................
..@@...................@......
.@..............@.....@....@..
............@....@.........@..
...........@....@.......@.....
.........@............@.......
.........@........@@..........
........@.............@..@....
........@.........@@...@......
...@..@..........@@@..........
.................@@.....@.....
..............@@@.............
....@..@............@......@..
.........@....................
..@..........@.............@.@
