30,30
........@.......@.............
@.....@......@...@............
.@...@............@...........
......@....@.@.......@..@....@
............@.....@.........@.
.......................@@@@.@.
@................@............
..................@.........@.
.....@.........@..............
........@.....................
.........@@........@...@..@...
........@@.......@.....@@.....
.........@..@.....@...........
.............@.......@........
..............................
.............................@
@...@.................@.......
............@@........@.......
...........@..................
....@.......@.................
..................@...@.......
.......@..................@...
..........@@......@..@........
..........@...................
..@....@@................@..@.
@.....@...............@.....@.
..@...@...@........@.......@..
............@@.......@........
..@.@@..........@...@.......@.
...........@@....@............
