30,30
...........@..@............@..
.........@.@..................
.......@@.....................
......@.......@.......@.......
...........@....@...........@.
........@....@................
.........@@..@....@.......@...
...................@....@.....
...@.........@................
@.......@..................@..
....@......@........@.........
..............@.@.....@.......
..........@.....@.............
..........@.........@.........
..........@@...@...@..........
............@...........@.....
......................@.......
....@@..............@.......@.
........@...@...@.............
..............................
....................@.......@.
...............@@......@......
...........@...@..@.@.@.......
.......@@.............@@......
..........@..@...........@.@..
..@@..............@@.....@.@..
.......................@..@...
.......@.........@.@..........
........@..............@.....@
....@@@...@....@@...@.........
