30,30
..............................
........@..@.@................
.@...@..........@.......@.....
@....................@.....@..
.............@....@...@.@.....
.........@..@...............@.
..@.....@.......@.............
.................@.......@@...
.......@....................@.
.......@..............@.......
.....@...@................@...
................@.............
..........................@...
........@........@....@.....@.
..@...@.....@.................
..@@....@.........@.@..@@.....
...@@................@.@......
................@..@..........
....................@.........
..............................
....@......@..................
..............................
..@@....@........@............
.................@..@..@.....@
..@..@....@...@....@.@......@@
.....@..@.............@....@..
......@..........@@.@..@......
......@@@...............@.....
............@........@........
@............@..@........@....
