30,30
.....@......@@...@.....@.@....
................@.............
............@..@..............
..........@...................
..............@...@.......@...
...........@.........@........
..@......@............@..@....
.@..@.................@.@.....
..@.......@.........@@....@...
.....@.........@.....@........
@@....@.@.......@...........@.
..@....@................@.....
.............@................
...@..........................
..@..............@@.....@...@.
..........................@@..
@.............@.......@.....@.
...@...................@......
.@...........@................
......@@......................
..............................
........@.............@@......
.@..@......@.....@.@..........
.......@......................
....@.........@.....@........@
..................@.@...@.....
@........@..................@@
.@.......@..............@.....
....@......@@.@...............
.@...@...............@.......@
