30,30
.......@.........@............
......@........@..@.......@...
...@......................@...
.....................@........
.....@........@...............
..@...........................
...........@..@......@....@.@.
....................@.......@.
..@@........@.....@..@........
.............................@
.@......@@......@.......@.....
.....@.@..@................@@.
......@.......@.............@.
@.@......@..@....@............
..............@@@.............
@.....@.....@@.@..............
..@....@......................
@....@......@..@...........@..
.......@....................@.
...@..@......@.@..............
...@...@.................@@...
..............................
.................@@..@........
..........@..@.@....@....@....
@........@@...................
.....@.........@...@...@......
.@...............@.......@....
....................@...@.....
...........@..................
.............................@
