30,30
......@......@.............@..
......@...@..@.@.......@......
.....................@........
...@..........@...............
.........@...@.@......@.....@.
.@............................
...................@..@.......
....@...............@...@....@
@...........@..@..............
.....................@...@...@
................@.............
........@@.@..................
......@.....@.........@.......
@.@..............@.....@.@.@..
......@.......@@.............@
...@......@.....@.............
.........@.........@@@....@...
...............@..........@...
.............@.......@...@....
..@.............@.............
..............................
.........@.@................@.
.....................@........
....@......@@..........@......
......@...................@..@
.....@...@.....@.@..@@........
......@....@@......@..........
.......@......@.............@.
@......@...................@..
.......@..........@...........
