30,30
....@.....@...............@...
............................@.
................@@..@......@..
..@...........................
.@.................@..@..@....
.@...@....@.....@....@....@...
...@....@.........@...........
.........@....@.....@.@.......
........@...............@.....
...........@................@.
.@.@.........@.@..............
.................@.......@.@..
..........@...............@...
..........@...................
.......@........@.....@..@....
.............@..@.............
.............@...@............
.......@.......@..@...........
..@..@...@....................
..@........@..@@..............
..@................@.@........
.@@@..........@...............
.@...................@........
......@.........@.........@...
....@....@....................
....................@.........
........@..@..................
.....@.....@@@....@@.@..@.....
.........@..@....@.........@@.
................@.........@...
