30,30
........................@.....
....................@.@......@
...........@.@.@..............
..@........@........@.@.....@.
.....@........@@.........@.@..
..................@.....@.....
............@.@...............
....................@......@..
..........@....@@.....@.......
.............@...@....@...@...
.@.......@....................
@..........................@..
.....@.@.......@......@@......
...........@...@............@.
...@.@..@@..........@.@......@
..........................@...
..............................
..........@......@............
...................@..........
..@.......................@...
@............@..............@.
.............@......@.........
.........@........@...@......@
@..@@.....@..@.@....@.........
........................@.@...
@.........................@...
...................@.........@
...@....@..........@..........
.@.....@..........@...@@......
.@........@...@............@..
