30,30
..........@...@..........@@..@
...@..................@.....@.
.@.@...........@..@..@..@.....
@.....@..............@........
.......................@......
@..@...............@..@..@.@@.
....................@....@.@..
....@.............@...........
.........................@....
.@..@.........@...............
....@.......@...........@.....
...@....................@@....
...................@.....@....
.@.@..................@.......
..........................@..@
............................@.
....@...@.....................
@@............@.............@@
...........................@..
.................@............
..@..........@...@............
.........@....................
@.@..@..@@...@...........@....
..@...@.......................
.@@.@.....@..@.....@.........@
...@..........@.....@......@.@
........................@.....
@...@...........@.............
................@.....@@......
...........@..................
