30,30
.........................@...@
..........................@...
..........@......@..@@........
.@.@@.....@..@................
...@@.............@.@.........
...................@..........
..@.@.........@...............
@.....@...@@.@.......@........
..............................
..............@..........@.@..
.................@..@.......@.
.@..........@.....@...@.......
...@.......................@..
..@....@..............@...@...
.....@....@...@..@.....@......
........@.......@.............
@..@..........@............@..
.@...@........................
..@.......@..@@.........@@@...
.................@..........@.
.......@.@@..............@....
.....@...............@@...@...
.@..............@......@@.....
.@.....@........@......@......
....@...........@.............
...............@..............
.........................@....
............................@.
.............@............@...
.......@...................@@.
