30,30
...................@@.........
........@@.@@.........@.......
.....................@........
.@..........................@@
..........@...............@...
.@........@...........@.......
..........@..........@..@.....
...............@..........@...
..............@.......@@......
.@...........@...............@
.............@...@............
...............@..........@...
....@...@........@....@.......
...@................@....@....
.@..@..............@...@.....@
...............@..@......@....
..@...................@@...@@.
............@.@....@@.....@...
..............................
.....@@..................@....
..............................
......@........@..@..@........
.................@............
...@..@..@.......@....@....@..
......@.......@...@........@..
.......@@....@................
.......................@...@@.
....@...@........@............
.@..................@@.@.@....
.......@..............@.......
