30,30
......@.................@@....
...............@..@..........@
.@............................
@............@.........@......
....@@....@..@..@.........@...
.........................@....
.@..@..@..@...............@..@
..................@.....@.....
...........................@..
........................@.....
..............................
........@......@..@.....@.....
.@............@...............
.........@.........@..........
..........@.@.................
.....@............@....@....@.
............@..@.............@
..........@..@................
....@.@.......@@@....@........
....@...@...@.................
...@@@.......@...@.....@..@@.@
......@.......@...............
.............................@
..@..............@@.@....@....
.....@...............@........
@...........@..........@......
.@..........@................@
..@.....................@.....
...@.....@........@..@.@......
........@.............@......@
