30,30
.......@...@....@...@....@....
..........@@@.@..@.........@@.
...............@..............
..@@..........@...............
........@..........@.......@..
...................@......@..@
..................@...........
...........@...@....@.........
........@.....@@...@.......@..
.@...........@..........@..@@.
......@.....@@....@.....@...@.
@.@............@.....@..@.....
.......................@......
......@..@......@.............
@..@...................@......
@...................@....@....
.........................@....
..............@.....@....@....
..............@...............
......@.....................@.
....@.............@...@.......
...........@........@........@
.@.@..........................
@.....@...@..........@.....@.@
.................@..@.........
.............@................
................@.......@.....
..........@..@................
...@....................@.....
....@..........@....@.........
