30,30
.....@.....@......@.@........@
..@.......@..............@....
..@...........@......@........
................@@......@.....
......@........@.@....@.......
....@.........@.......@.......
......@..@........@...........
.............................@
....@.@.......@...............
........@.@..............@....
..@......@.............@@..@..
....................@.........
...................@....@.....
........@..............@......
...@..............@@....@.....
......@.......@...@...........
.@........@.@.............@...
........@.@....@.@............
..............@...............
.@................@...........
..............@.......@@......
.@.............@.........@...@
............@..@........@....@
@.@...@...@...@...............
...@.@........@...............
............@........@........
@..................@.@........
............@.................
............@...@.............
......@..@.....@............@.
