30,30
........@.....................
....................@.........
..@........@.......@.......@..
.....@..@...............@.....
..............................
@.....@....@..@......@........
....................@.@...@...
....@.........................
..@...........@......@@..@....
..............................
..............................
.......@...........@..........
...@...............@..........
.@.@.......@............@.....
.@........@.@...@.............
@..@...........@..............
......@......@..@.............
...@.@....@@..................
.@.............@..............
....@...........@..........@..
.......@.@@....@....@.@.....@.
..........@....@@.............
.........@....@..@............
@.....@.....@.@.....@.......@@
..........@..................@
....@.............@..@@.......
.@.......@.@...@..@...........
...@..........................
.......@.@...@.............@..
...@....@..@.........@........
