30,30
@........@.....@@.............
.............@..@@............
..@.............@.............
........@..@..@...............
................@.............
...............@.......@.....@
.......................@.@....
...........@...@............@.
................@......@....@.
.@................@.......@...
...................@......@...
.@...........@.....@..........
.@...@...@..................@.
............@........@...@....
................@.............
............@.@.....@...@...@.
.@.....@.@.............@......
.........................@....
................@.......@.....
....@......................@..
.........@.....@.............@
........@....@....@...........
.@.....@...........@.@......@.
..........@......@....@.......
...@..................@.@.....
....@..............@.......@..
........@.@...................
......@..@...@..............@.
..........@.....@.....@....@..
.@@.......@.......@@.....@....
