30,30
..............................
@.....@..@...........@...@....
......@.......................
.........@......@........@...@
.....@........................
..........................@@..
.@.....@...................@..
......@.......................
.@................@....@......
...............@...@..........
........@.......@...@.........
.........@.@.....@@...........
...@......@.........@.....@...
.@...@@..........@.@.....@....
..........@..........@......@.
.......@@...........@.........
................@.............
@@.....@..@..........@.....@..
..........@............@..@...
............@............@....
...................@....@.....
.@............................
@...................@..@......
.@....@......@..........@.....
...@....@.......@.@....@....@.
@..............@....@.........
........@..@........@......@..
..............................
......@....@......@..@....@...
@..@.@....................@.@.
