30,30
...@..........@...@....@......
...@...@@.......@.....@..@....
..@.......@.@@...@...........@
...............@..............
.............@..........@.....
......@...@.................@.
.........@@@..@...............
.@@...................@.@.....
....@......@...@.....@........
........................@@....
.......@......................
@.................@..@........
.@....................@.......
....@.........@............@..
......@.......................
..............................
..........@...@......@.@.@....
..............@...@.@@........
....@........@...........@@...
..............................
........................@@....
....@................@........
......@.....@.....@@..........
.....@.@.@....................
.@@...........@.........@.@...
.........@....................
......@.@.......@............@
.............@....@.....@@....
.@...............@.@........@.
..............@.......@.......
