30,30
...............@...@@.......@.
.......@........@.....@.......
.........@.....@.@............
..@..........@@.............@.
.@............@@....@.........
@...........@...........@..@..
@@...@........................
............................@.
@..................@....@.....
@......@.............@........
...@.........@@.........@.....
..............@...............
.....@.@......................
.@...@.@..@...................
.......@....................@.
...............@..............
.....@..........@.............
.@..@......@.............@....
....@.............@.@........@
.@.....@....@............@....
.......@.@............@.......
........@......@..............
..............................
.......................@......
@.............................
........@.@.......@......@@...
.@....@.......................
@.......@....@....@@.......@..
.....@...@.....@@.....@.......
....@..............@.@..@...@.
