30,30
@..........@...............@..
............@.........@.....@.
.....@..@.....@........@....@.
.............@................
.@.....@@...................@.
@...@.....@..@..@....@..@@....
.....@............@......@....
..................@......@....
@........@...........@........
......@..@.................@..
..................@...........
...........@...@.......@......
.........@......@..@..........
.............@.............@..
.....@.......@@..........@@...
..............................
...@..........................
..............................
.................@......@.....
...@....@.........@...........
.....................@......@.
..........................@...
.....@......@........@........
...@.@...@....................
..@..@......@............@....
.............@@.......@...@...
......@..@@...@..@.........@..
@..@..........@.....@.......@@
...@..............@....@......
@........@..@.................
