30,30
...............@....@.........
................@.............
...................@....@.....
@@..........@.@...............
@...........................@.
.............@................
......@.............@...@.....
......@........@...........@..
.....@.............@........@.
.....@................@...@...
............@.........@.......
..@..............@.....@.....@
.@.@...@.....................@
..............................
..@.........@@......@.......@.
..@@.......@........@@........
..................@..@...@....
.....@..........@.............
@.@.@.@........@@.@.....@.....
........@@......@..........@..
......@.@.....@...........@...
....@........@.........@......
....@...@@..............@.....
....@...........@...@.....@...
@...............@.............
..................@.@.........
.@............@...@.@......@..
..........................@...
........................@.....
............@........@..@.....
