30,30
..............@.@.......@...@.
.............@....@.....@..@..
..@....@@.....................
..@@.@................@.......
.....@.@@.....................
...@@..@......@.........@..@..
............@..............@..
.......@......................
.@............................
@...@.............@...........
....@.........................
.................@.@.@.@......
...............@..............
....@@.@.................@....
......@.......................
...@........@.......@...@.....
..@......@...@..............@.
......@......@@....@..........
......@..........@....@.......
.....@.....@....@.........@...
.....@.@...@....@...........@.
.........@..............@.....
.......@........@.............
........@....................@
...@.........@..@@.........@..
........................@.....
........@...@...@......@......
...@..@.........@@...........@
..........@...........@.......
..........@...................
