30,30
...@....@............@.@.@....
...............@.............@
..........@....@.@.@@.........
..@........@......@...........
....@..@.@.....@@.......@.....
..@...........@..........@....
@.@@.....................@....
..................@...........
..........@...................
..@@.................@....@..@
.......@.@...................@
....@.........................
..........@...................
..@...........@..@............
........................@..@.@
.@.........@...............@@.
@..@.............@...@........
..@........@..................
...@@............@.....@......
.@........@..@............@...
....................@.........
.....@........................
..@...........@@...@..........
.@....@.@.@...............@...
.@.................@........@.
..............................
............................@.
...........@.....@......@..@..
.................@...@.......@
..@..@.@..............@.......
