30,30
.........@....................
@..............@@.......@.....
.........@....@......@..@.....
....@....@...@................
......@..............@........
...@........@.................
...@..@.@............@........
..................@.@........@
.........@..........@...@@....
.......@..@...................
.....@.....@.........@........
....@.........................
....@..................@.@..@.
@..............@@........@....
.................@.......@@...
............@@....@.....@.....
..............................
.......................@......
@..................@.....@...@
..................@...........
.....@@........@..............
...@...........@......@.@@....
......@..@.@..................
.@.........@......@...........
..........@........@@.....@@..
@..@.@....@.@................@
....@........@................
.....@.....@.@................
...............@....@.....@..@
.........@.........@..........
