30,30
@...................@.........
..............................
.@......@..@..@......@..@.....
..............................
@...........................@.
@@.......@.....@..@.......@.@.
.@........@.....@...@....@....
.........................@....
.....@....@.....@...@@...@....
........@.............@.......
.........@..@.................
....@...@@...@................
.@.............@........@.@...
.....@........@.......@..@....
....................@....@.@..
..........@...................
@....@...............@......@.
...@.....@......@....@..@.....
.......@......@@....@@....@...
.........@.@.............@.@..
.................@..@....@....
...........@.@.....@..........
....@.@@.......@.............@
..............................
......@.@.....................
................@......@......
..............................
..................@...........
................@......@......
.....@..@..............@.....@
