30,30
.....@........................
....@........@...@............
.....................@.@......
...................@..........
@.....@.......@........@......
..@..........@........@..@....
@....................@@@@@@...
.....@.@.....................@
............@..@........@.....
............@........@........
.......@.....@..........@.....
................@......@......
.@.@.....@....................
.......................@......
.....@........@...............
.....@...........@.@.......@..
@...........@.........@.......
.........@.......@............
.@....@......................@
..................@.@@........
............@.................
........@.........@.@.@..@....
.@..................@.........
.@...................@..@...@.
......@..@.@...............@.@
...............@.............@
@......@@.@..@.....@....@.....
..............@......@.@......
.....@.......@................
..@..@...........@............
