30,30
.................@.........@..
...@.......@..................
.@..........@.................
...@.....@..@.....@@..........
..@................@...@......
............@.@.@.@...........
......@.............@...@.....
.....@...........@..@.........
......@...............@.@.....
..............................
..@................@..........
.....@................@.......
.@....@.......@.........@.@...
...@.........@........@.......
...@..@....@.....@@..@........
................@..@......@...
.....@........................
@..@........@.................
..........@..@...@@..........@
@....@.......@....@.......@..@
...@....@......@.....@@.......
...@@..................@......
..@........@..@...........@@..
..@...........................
.........................@.@..
.@.......@.................@..
.....@........................
..@.................@.........
........@..........@.......@.@
...........................@..
