30,30
.................@@...........
.@@...@.....@...@@............
....@..@....@@@.@.............
.@...@.......@@...........@..@
..............................
.@............................
@..@.........@@...........@...
....................@....@.@@.
...................@..........
......@.......................
..................@.@..@.....@
..@...............@...@...@..@
@..................@..........
.................@...@....@...
.....................@........
..................@...@.......
.............@......@......@..
@.............@...............
..@.......@.@.................
......@.............@.........
....@..@..................@...
....................@.@.......
.......@....@.................
.....@......................@.
.........@.......@............
............@.............@...
..........@......@.........@.@
.........@........@.....@.@.@@
.....@..................@...@.
......@....@@....@....@.......
