30,30
....@.................@....@..
....................@.........
.......@..@...@....@@...@..@..
..............................
..@....@...@..................
........@......@............@.
....@@........................
@...........@.@...@@...@......
@......................@@.....
..@...........................
.....@@.......@@..@.@.........
.....................@.......@
.................@.......@....
..............@............@..
...@...@....................@.
......@..@...@...............@
...............@...@@.........
.............@..............@.
@........@.........@........@.
......@...........@......@....
.....@........@...............
...........@....@.....@....@..
...........@....@............@
...@......@.....@.............
......@@........@...........@.
@@............@...@@..........
.@............@...@...........
......@..........@.......@....
..@.............@.............
....................@.........
