30,30
..............................
...@......................@...
.......@........@.....@.......
.......@@..........@.........@
.................@....@......@
.....@....@...................
.....@...@..@...........@.....
........@.....................
.....................@.@......
......@@...........@.........@
.@@.......@.@@.......@........
.......@........@......@......
.............@.........@.@....
..@...................@.......
........@@.........@@@........
...@.@........@.@....@........
....@................@.@......
...................@@@....@...
.....@.....@...@..............
...........@...@.......@......
.....................@....@...
................@..@..........
...........@.......@..@..@....
................@.............
..@@...............@..........
..........@...@..............@
........@..........@....@.....
....@@........@......@........
.....@........@...@...........
....@...........@@............
