30,30
.......................@......
.....@.....................@..
.......@.................@....
..@...@.......@...............
.......@..@.........@......@..
..............@...........@...
............@........@........
..@...................@.....@.
.................@...@......@@
@.@......@....................
.............@.@@..........@..
...@.............@.@....@....@
...@@...@....................@
.@.@..@.......................
........................@.....
...@......@...................
.....@........................
...@.....@.........@..........
@..............@@.............
....@............@...@.....@..
........................@@..@.
................@@............
..........@.......@......@....
.......@@....@..@.............
.....@.....@.............@...@
..........................@...
..@.@@.............@..........
.@..@.........@.@.....@..@....
@.................@.......@...
...............@.....@@.....@.
