30,30
.@.....@...@....@..........@..
..@........................@@.
..............@...............
.@.....@..........@.........@.
...@....@....@............@..@
...........................@..
.@...........@...@.@...@..@...
..............................
.....@.....................@..
........@.......@.............
...@..........@........@......
.........@.....@..............
.............@................
............@.................
.@....@.@....@@@..@.......@...
................@.............
...@.....@....@@........@.....
.........@............@..@....
................@...........@.
..@@@.........@............@..
......@.....................@.
............@.....@..@..@...@.
...@.@.@...........@.....@....
.......................@...@@.
...............@...@.@........
@.............................
....................@.........
..........@...................
.............................@
@....@@....@@.....@....@@.....
