30,30
......@.......@.............@.
..................@...@@.@....
...@@........@...@............
........@.....@.......@....@..
@..............@........@...@@
.........@........@...........
.......@...........@..@.......
.......@......................
............@......@@.........
.@.............@..........@...
........@...........@.........
.............@............@.@.
..@...........................
...@......@..............@....
.......@......................
...@.@.....@.......@..........
.......................@..@@.@
.@............@.........@.....
..............@..@....@.......
......@.@.......@..@....@.....
..................@@..........
.....@........@...@...........
......@.@...@.....@@..@.......
@.............@...............
.@...@..............@......@..
.......@....@................@
........@......@..............
.......@.@....................
...@.@........................
..@...@......@................
