30,30
.....@....@.......@...........
...@..........................
......@........@.@.......@...@
......@.........@.@@.@.....@..
....................@.........
..................@...........
......@.@.....@.@.......@.....
.@.............@.........@....
@.......@......@....@.........
.....@.........@........@..@..
@........@.......@.......@..@.
..............................
................@.....@.......
@..........@......@...........
.....@..........@.@..@.@......
.................@............
@.....@.....@......@..@.......
............................@.
........@..@..................
..@.@@..............@....@....
...@......@...................
..............................
..@.....@...@.@....@..........
@@@....@..........@...........
.......@......................
..........@...................
.@...........@...........@.@..
......@..........@.........@..
.@@.......@......@............
..........@..@............@...
