30,30
@.......................@@@...
.......@...@..@..@............
..@...@..@...............@.@..
.................@............
..............@.@.............
......@..........@............
..@.......@........@@.......@.
...........@.......@..@.......
@........@@............@......
.......@.....................@
........@..............@@.....
......@........@..............
................@@......@.@...
.....@@.........@.........@...
.......@.@....@.........@.....
...@..@..............@......@.
....@........@....@.......@..@
..............@...............
.........@..@.................
.@.......@.....@..............
@...........................@.
.....................@........
.............................@
...@..@......@......@.........
....@..........@..@...........
.........@..@..............@..
........@..@......@......@....
...@........@...............@.
.@......@...............@.....
.@.........................@..
