30,30
...@....................@.....
.............@..@.....@.....@.
...........@..................
.......@......................
.@@.......@...........@.....@.
........@.......@........@@.@.
@...........@.................
@@........@......@............
......@...@.....@.............
...........@@...@.............
......@@@.@....@..@...........
..@........@.......@..........
..................@....@......
....@.....@......@..@.........
..........@..........@........
......@.@....@......@.........
.........@........@.@..@......
...@..........................
.@............@........@......
....@................@.@.....@
............@.....@.........@@
@...@................@@....@..
..........@........@........@.
.......................@......
..............................
....@..@..........@@..........
.@......................@.....
..........@...@........@......
....................@.........
.....@.@......@........@......
