30,30
..............................
@..@..@..@..........@.........
@........................@....
....@.........................
...@.............@@...........
..@@.....@................@...
.........................@....
..............................
.............@@...............
..@..............@............
@.@.........@...@.....@.......
..............@@....@.....@..@
...@.@........................
..............................
@...@...@.@...@....@.@........
......@.@........@......@..@..
.......@.@@@@.....@..........@
.....@.@....@.........@.......
......@.......................
...........@.@.@......@.@.....
........@...........@.........
.............@................
..............@...............
.........@.................@..
.....@.....@......@@.......@..
...@.......@.........@@.......
.........@..@.....@...@.......
..........@.......@.@.........
..@..................@.@......
.......@..@..@@...............
