30,30
.....@.......@@...............
..@.....@.....@...@.....@....@
.............@.........@......
...@...........@......@.......
@........@.....@...........@@.
...@........@.@@..............
....@...@..@.........@........
.....@........................
...........@.........@......@.
@.........@..........@.....@..
...@.........@...........@....
.............@.@.@......@...@.
.......@........@..........@@.
.@......................@.....
....@.........................
...............@....@..@......
.............@@.....@.........
.............................@
@......@..@@.@@.....@.......@.
..............................
........@.@..........@........
..........@...................
..@........@.......@......@...
................@...........@.
............@............@@...
......@.....................@.
.........................@..@.
..............@.....@...@.....
......@..............@........
...@.@.............@..........
