30,30
..........@...................
...........@..........@.......
.@...@..........@.@........@..
...........................@..
............@....@............
@...@@@.@...........@.........
.....@..@.....@...............
........@.@...................
.........@.@@.@..@............
@.@.........@..........@......
......@................@......
...............@.........@@...
.........@@...................
..@..........@@.......@.......
..............@...@......@..@.
......@........@.@...@......@.
........@@....@..@............
....................@...@.....
...................@.....@..@.
...........@..@....@.........@
.........@.......@.@@........@
..@..............@..@...@.....
.@..............@........@....
............................@@
...........................@..
.......@@.................@.@.
..................@...........
..........@...................
@......................@....@.
..@........@..................
