30,30
.......@...@.......@..........
.........@........@...........
...@.......@............@@@...
.@..........@..........@......
..@@.......@.......@..@@..@.@.
...@............@...@......@..
......@.@...........@.........
.........@............@.@.....
..........@........@.........@
......@............@.....@....
....................@.........
.............@................
...................@@......@..
................@..@@.........
@..........@....@.@.........@.
.......@...........@..@@......
..............................
...........@...@........@.....
......@.........@.............
...@.@..@.....................
....@....................@....
.@...............@..@.......@.
@.............................
.............@.........@...@..
..........@........@.........@
@....@...................@....
..................@@..........
.@.................@@.........
..@.....@.@.....@.....@.......
..@...................@.......
