30,30
...@.....................@....
.........@..............@.....
....@..@.........@......@...@.
@......@..@...................
....@@............@.@.........
@...........@@......@.........
...........................@..
........@.....................
......................@.@.....
...............@@@..@...@..@..
.....@................@...@.@.
.....@........................
................@..@.@........
.........@..@.................
...@..@.......................
....@........@@...............
....@...................@.....
@@.........@................@.
......@.........@....@..@..@..
@............................@
........@.....@...............
.......@........@.@@...@......
.@@....@.......@..............
..@...........................
..@.................@.........
..................@.....@.....
...@....@..@..........@...@...
.@..@...@.................@...
...........@.....@....@.......
@............@...@.@..........
