30,30
..@.........@.@...............
....@.@...........@........@..
....@.........@..@.@..........
..@.........@..........@......
...@...........@@..@..........
.@.....................@......
..............@...............
.@...@@.....@...@........@....
..............................
@@..@..............@..........
...............@.@........@...
.............@........@.......
..........@......@.........@..
.......@......................
........@...@.@@........@.....
.........@.......@..@..@......
....@.@@...........@.@........
@..........@...............@..
@............@...@...@......@.
..............................
............@.......@.........
..............@..@...@........
...............@..............
...............@......@......@
......@.@.@@..................
@......................@......
.@.....@............@.........
......................@@...@..
....@........@................
..@.@......@..........@..@....
