30,30
........@...@.................
..@........@..................
..@..............@.@@.@.@@@.@.
.@...@.@..@...........@.......
..@..@....@..............@....
............@@................
.....@@........@.........@....
..........@...............@...
..............................
.@@..@.@.@........@.@........@
........................@@...@
...............@@..@..........
.......@......................
...@.....................@....
.........................@....
........@.....................
.......@.@....................
...@..................@.......
....@.@..@@......@..@.......@@
...@.......@......@...........
.....@........................
.......@..@.@.@.....@.........
.....@......@.@...............
.........@@@.@......@.........
....@...............@.........
.................@.@.@.@.@@...
..............................
..@...........................
....@.........................
@......................@......
