30,30
@...........@.................
......@.......................
..............................
.............@...@............
.........@@...@........@..@...
.........@..@....@............
@....@@............@.@.@.@....
..............................
..........@.@..@.......@......
....@....@...........@@.......
..................@....@......
.....@.....................@..
..............................
........................@....@
........@....@...........@.@..
.....................@.....@..
....@.@...................@.@.
@..@....@.....................
.@..........@.................
..................@@....@.@@..
...........@..@.@@@......@...@
@@..........@.....@...........
..............................
........@....@................
..............................
.@............................
.........@...@.....@.@..@.@...
...........@.......@.......@@.
..@.........@..@@.......@.....
.....@..@.@..@.@...@........@.
