30,30
..........@.@.....@...........
......@..@...........@@.......
.........@.....@.....@........
.........@....................
.......................@...@..
.............@.@.....@........
.....@...........@............
....@....@..@.........@.......
............................@.
......@@......................
.........@.......@.......@....
..........@.@.......@....@@.@.
...@........@.....@.@.........
.................@..........@.
...@....@..........@..........
.........@...@..@@............
......@............@.........@
..@.@...@..@.@......@.........
....@.....................@...
.@@......@................@...
.@....@..........@......@.....
.@.@.@....@.............@.....
..............................
.......................@.....@
............@......@..........
...@....@.........@@..........
...........@....@.............
.....@@...................@...
..............@...@.....@.....
....@......@@.................
