30,30
@..@........@.................
.....@................@.......
...@.............@.....@...@..
.........................@....
.@.....................@....@.
..@........................@..
.@@.......@...............@...
..@...........................
...@...@............@.........
...........@@@........@.@.....
@............@.........@.@....
.....@........................
.....@...@..............@.@@..
...@.............@.........@..
........@.........@..........@
...@.@..@@.............@......
.........@......@.....@.......
.......................@......
.@...................@...@....
..@@.......................@..
......@......@...............@
..........@.........@.........
........@..@..@.............@.
........@..@......@.....@..@..
@.@.......@...@@....@.........
......@...............@..@....
...@..............@...........
........................@.....
..@@..@.......................
.....@........@...............
