30,30
...........@..........@.......
........@....@..@........@.@..
.................@............
...@............@@......@.....
..........@...................
@................@@......@....
..........................@...
@.............................
.......@......................
.........@........@......@...@
..............................
.......@.....@.......@........
......................@@......
.@...................@........
.@..........@..@...@..........
..................@...@.....@.
.@....@@.@@.@..........@......
...........@....@.@....@......
..@.........@....@.....@@.....
...................@........@.
@............@.....@..........
@...........@.........@.......
....@.....................@@..
...@..........@......@@...@...
....@.....@...@..............@
...@.......@.............@....
.......@....@@...@............
....@@..@.....................
........@.....................
.@..........@@...@....@.......
