30,30
.....@....................@...
...@...@....@.................
.....@....@...................
............................@.
.@....@....@..............@.@.
......@............@....@.....
...@.@@..............@........
.......@@.....@..............@
.@@........@@...@.@....@....@.
.@..@.....................@...
..@.........................@.
.....@..@...........@......@..
..............................
.........................@....
........@..@...@..............
.......@...@...@.......@......
...@.....@.@@@................
.......................@......
.............................@
...........@..@.......@.......
..@.....@.....@..........@..@.
.....@.@....@.......@.........
........................@.....
.@.@......@....@.......@......
............@...............@@
....................@.........
@.............@...@......@.@..
...@..@.....@............@....
.....................@........
...@.......................@..
