30,30
..........@........@..........
.....@..@.................@...
.....@.@........@.............
.@......@.......@..@....@..@..
.....@.....@..........@.......
........@.....................
.@........@@...@....@.........
..@....@...............@......
......@......@.............@..
........@.........@....@......
..........@...............@...
..............@..@............
.....@.......@.......@........
.....................@........
............@...............@@
...@.............@............
..@..@.....@................@.
@....@........@.....@....@.@..
........@...........@.........
@.....@...............@.......
............................@.
..............................
....@@............@..........@
...........@....@.............
..............@@....@....@...@
.........@.....@..@..@....@..@
.......@@......@..............
@............@................
.@.@................@......@.@
...............@@.............
