30,30
@..........@..................
...@...........@............@.
.......@@.@......@.....@......
@.....@.............@@........
.........@......@.....@.....@.
....@.........@.......@..@.@..
.......................@...@@@
..........@.....@.............
....@.........................
......@........@....@@........
....@.....@....@@..@..........
..@....................@......
...........@.......@......@...
............@.@.....@...@.....
....@.................@.@.....
....@.......@....@.....@...@..
........@...........@..@......
............@.......@.........
.....@.............@......@..@
....@.........................
...............@@.............
.@.......@....................
@.@............@..............
.......................@......
...@............@.............
........................@.....
...@....@...@@@.....@........@
.........................@....
...........@..................
............@.........@..@..@.
