30,30
@..............@..@...@@......
...@@.........@........@.@....
..............................
...........................@..
.@..@......@.......@....@..@..
.......@........@.@...........
...........@...............@..
......@.....................@.
......................@.......
@.@.........@....@............
......@@.........@..@..@@.@...
..............@.@............@
@.........@...................
.....@............@......@....
..............@...........@...
.......@@.......@......@......
..........................@.@.
...........@........@@........
..........................@...
.@.@..........................
.@............................
...@..........@...........@..@
.@...@@@...........@.........@
@.......@.........@........@..
......@....................@..
.......@..@..@@............@..
...@..........................
@....@........................
........@........@............
..@........@.........@..@....@
