30,30
......@....@...............@..
..........@...................
......@...@.................@.
..@..............@...@......@.
....@.....@...................
....@...........@............@
.......@.....@@.@....@........
..........@...................
...@..@.......@...............
.........................@....
@.............@....@@.........
@..........@@.......@.........
.@.@.....@.@.....@.@..@.....@@
........@.@..................@
..@.........................@.
..........................@...
...@...............@.......@.@
..................@...........
......@.......................
@.......@............@........
.@.................@@........@
.............@.@.....@@.@.....
@...........................@.
.........@...@................
..@.....@............@...@..@.
......................@.......
........@.......@.@.......@..@
......@.......................
.@.......@....@..............@
..........@..........@...@....
