30,30
................@.............
......@..................@....
.............@......@....@@...
.............@..........@..@.@
...@@..@.........@............
...........@.....@..........@@
@........@..@................@
...........@......@...........
..........@@.....@.........@..
.........@....................
.@.....@............@.........
............@.@.......@....@..
................@@............
..@..........................@
................@.............
@..........@......@...........
....................@.........
.........@...............@@...
.......@..@...................
.....@..@.@@..............@...
......@...........@...........
..............@...@..@......@.
....@..@@......@.............@
.@.@.............@..@...@.....
..............................
............@..@.@..........@.
.@...............@..........@.
.......@....@.......@.......@.
..@..............@..@.........
....@................@..@@....
