30,30
........@...............@.....
.......@@.........@...........
..............................
..@.......@...@@......@.......
.@....................@@......
....@...........@..@..........
............@..@......@.......
..............@..........@....
.............@..........@.....
..............................
......@.......................
..........@.@....@..@@...@...@
..@............@.@...........@
..@.............@......@...@..
..............@...............
....@.......@..............@..
.@...@............@...@@......
...@................@...@.@@..
........................@.....
..@.@......@....@........@...@
.........@..........@.........
.........@...........@........
....@@......@.@........@@@..@.
..@....@.......@...@.@@.......
..........@.@..@..............
.....@........................
...@..........@.....@........@
...................@......@...
@.............................
.......@......................
