30,30
...................@.@@.......
..@......@..@...@..@........@.
.@.......@.@.@...@............
...@@..@........@......@......
.@..........@.@..@........@...
.......@@............@........
.............@.....@..........
................@.............
...............@....@......@..
..@.@...@@..@............@.@..
.....................@........
..@.....@........@.@...@..@...
................@......@......
...@@.@.......................
.@@...........................
@..@.@........................
....@.........................
........................@.....
............@.................
.........@..................@.
..............................
..@.@.......@......@..........
..............................
......@........@.@..........@.
.@...@......@...@.............
.@.@..@.......................
...........@........@........@
@...............@..@...@....@.
...........@..................
........@..@................@@
