30,30
...........@..........@@......
.............@@...............
................@..@..........
..@...........................
.....@........................
.@........@.....@..@.........@
............@@................
.....@.............@....@.....
.............@................
...........@@.................
.........@...@@...............
........@@..@................@
..........@..@................
........@@.........@.@@.......
..@...............@...@....@..
..........@@..................
.......@@..@@@...@..........@.
..........................@@..
.@.@...@....@...@.............
............@...............@.
...@....@.@.............@..@@.
......@....@.@@.............@.
................@@............
.........@....................
....@........................@
..........@.....@...@......@..
..........@.....@..@..@..@....
@..@........@.................
.....@..........@........@....
....@.........................
