30,30
@......@...@..@.@...........@.
.......@...............@......
.....@................@.......
........@...@@................
@......@@...........@.........
................@.......@@....
...@..@.@..@.......@..........
......@..@...@.....@.....@....
..............@....@..........
.......@......@.......@.......
......@........@..........@...
.......@....@........@....@...
....................@.........
..............................
...........@.@..........@.....
...........................@..
..................@........@..
.@...........@................
..@@.@...............@.......@
..........................@...
......@....@.@@............@..
@......@.................@....
........@...@....@.......@....
@...........@@...@.......@....
.@@....@......................
....@.@..@.....@...........@..
......................@.......
.......................@......
......@..............@....@@..
.@.......@....................
