30,30
.........@....................
.@............@...@..@@.......
.....@........................
.......@........@..@.........@
........@.....@...@...@..@....
..@...........................
.............................@
.....................@......@.
..............................
...............@....@.....@...
.......@@@....@...@..@...@.@..
...........@......@.@..@......
...@............@........@....
@.......@@@.........@.........
.........................@....
....@.........@....@........@.
.......@................@.....
...............@..............
............@..@.....@........
.....@.....@....@..........@.@
...@...........@..............
@............@..@...@.........
@............@..............@.
............@................@
.......@...@..............@...
.@@@.........@.....@..........
...@...@.@....@.....@.........
.................@......@...@.
................@.....@...@...
......@.......................
