30,30
...........@......@...@.......
..........@@.....@.........@..
......@.....@............@.@..
.@.............@........@.....
..@..@....@.@..@..............
@...@.....@...................
...@....@.........@...@.@.....
.........@....@.....@..@@.....
......@.........@...........@.
..............................
............@.................
.@............@.........@.....
.@...@................@.......
.@@........@..@...............
@..........@......@...........
@..........@..................
..........@...................
.................@.....@....@.
....................@......@..
.........@@@..................
.......@......................
.@.......@...............@....
.@........@........@..@.......
......@..................@....
@..@..........................
.@@..@..............@...@.@...
....@.....................@...
.@@......@................@...
..@..@........................
......@.........@...@..@......
