30,30
..............................
..............@...............
......@..............@.@......
.....@.@.........@.@..........
....@...........@..@.....@..@@
@...................@.........
........@.....@....@.....@....
.......@....@....@.......@....
..@@.@........................
................@.............
.......................@.....@
.......@......................
.@@.@......@..................
........@...................@.
......@....@.@............@...
...............@....@...@.....
.........@..................@@
...@...................@.....@
..............@......@.@..@...
....@..@......................
@.@....................@...@..
.....@...........@..@.@@......
..................@.......@.@.
@...@.....@......@............
........@........@............
........@........@.@.........@
.....@..........@............@
...@....@.......@.............
......................@.@....@
.@..@..............@..........
