30,30
.........@....................
............@....@............
.....................@..@..@..
....@..@....@@........@@.....@
@.......@........@............
.....................@........
..............................
...@.@.........@...........@..
........................@.@...
...@........@.................
............@.@...............
.@..@.........@.....@.........
.....@......@.......@.........
@...........................@.
.@.@...@@....@..............@@
........@.....................
@@...@.....@.........@........
....@....@...@................
........@..@.......@.....@....
.....@........................
..........@....@@....@........
...@...........@...........@..
...@...............@..........
.......................@.@....
..............@......@........
..........@.....@....@.@.@....
..@..@@........@..............
....@.@.....@.........@....@..
........@.........@.@.@.......
................@...........@.
