30,30
............@....@............
.....................@@.......
...@@.....@...@...............
...@..@..@..........@.......@.
.........................@....
.......@..................@...
..@..@.@@..@.....@@......@....
...@........@.......@.........
........@...............@.@...
.@...............@............
.......@.@....@......@@.......
....@@......@.................
..@@..@..@........@..@...@....
.......@......................
..@.....................@...@.
.........@.................@..
...@.........................@
...........@......@...........
............@....@.........@..
.....@....@........@.@........
@...............@...@.........
..............................
..@.......@...................
........@........@.....@.....@
..@........................@.@
.................@.@..@...@...
..............@...........@@..
...........@.........@........
........@..@......@...........
...................@......@...
