30,30
.....@.@........@.....@.......
.......................@.@.@..
......................@.......
...@...........@.............@
..............@...............
......@.@................@..@.
@@....@...@...................
..@........@........@@....@...
@.............................
.................@.........@..
......@.......................
.@.@.....@....................
......@.@.@...........@.......
.@@...........@.......@.......
@..@...............@..........
.........@.............@@.....
.......@...........@.@..@.....
...@....@..@@.................
..............................
.....................@@.@...@.
@........@....................
....@..@..............@....@..
.............@................
..@.......@......@....@....@..
.@@...............@...@.......
@@......................@..@..
.@.@...............@.........@
....@.@...................@...
....................@@........
...................@........@@
