30,30
.........@...............@....
....@.....@.......@.....@.....
.....@...@..@.@.@......@....@.
...........................@..
.@@@.............@...@........
........@@....................
...@......@..@.........@......
........................@.@...
.........@.....@.............@
......@@.@..............@.....
.......@.....@@.......@.....@.
..........@..@@...............
..........................@...
......@.....................@.
....@..........@....@.........
....@..@.....@................
.............@.......@@.......
................@.......@.@...
........@....@.@....@.........
@........@....................
.......@............@.....@...
@.........@..@....@...........
.......@......................
..............................
.............@..........@@....
..@............@....@.........
@.............................
.....@....@....@.......@@.....
......@............@..........
.@............@..@.@....@.....
