30,30
.....@....@.@.......@.@.......
..........@.@.................
......@.......................
..............................
..............@.....@......@@.
...................@........@.
.............@...............@
....@...........@..@...@.....@
......@.....@....@@...........
....@...............@@@.......
...........@.@....@........@..
@.......@.....................
.@...........@................
..................@...........
@.@..........@@...............
..@...........@........@.....@
.@....@..@............@@......
.@......@................@....
@.....@...............@@.@....
...................@....@.....
.........@..........@@........
....@.............@...........
............@.......@........@
.@...@.....@................@.
...@......@..@................
.....@........@...............
.......@@.....................
...@..........................
.......@.............@........
.@@...@.......@..@...@..@.....
