30,30
...............@............@.
.........@...............@.@..
..............................
..........................@@..
...@..................@@......
..@.......@@.....@............
....@...@................@....
..........@..@.@..............
...@.......@..................
.........@....................
.......@.......@.....@..@.....
@.................@..@...@....
..............................
..........@...................
..@.........@.....@...........
@.@...........@...............
......@................@.....@
....@..@@......@..............
....................@....@....
.@....@............@..@.......
@.@........@....@.@..@....@@..
@....@...@..@.........@@.....@
.@.............@......@..@....
.....@...@..@......@@.........
...@........................@.
..............................
.@............................
...@.....@...............@....
.....@..........@@.@........@.
...........@...........@....@@
