30,30
......@.......................
.......@......@......@.....@..
...@.@...............@........
...@.@........@.......@...@...
.............................@
.@@.........@...@.............
@.........@...........@...@...
...@...............@....@....@
................@...@.....@...
..@.....@@...........@......@.
..@..@...........@.........@..
..@...........................
..@.........@....@............
.........@.............@....@.
....@.....@....@............@.
....@...@.....................
..........@.........@.........
.......@.....@........@.......
..@...@.......................
......................@.......
.........................@..@@
...................@.@..@.....
..@@.@...@.......@..@......@..
.....@@........@..............
.@........@.......@@......@@..
.........................@....
......@.......@...@...........
..............................
.@....@.......................
.....@...........@....@.......
