30,30
........@...@.@@.......@......
.@..........@....@.........@..
@......@........@.....@.......
.@...@........@.@@............
...@..@.....@.@....@@.........
.@.@..........................
...........@......@...........
....@........................@
......@......@................
................@........@....
..............................
..........@..........@..@.....
..........@......@.@..@..@.@..
..............................
@@@..........@...........@....
.@............@.......@.......
.............@@....@..........
.................@............
.............@@...@.........@.
.@...@........................
.......@...@.........@.....@..
...........@..........@.......
....@.....@...@...@@..@......@
..........@..............@....
....@.@.......................
..............................
....................@........@
.......@.....@.....@....@.....
............@....@..@.....@...
........@.........@...........
