30,30
............@..........@@.....
@..........................@..
..@...........................
.....@......@@@.@...........@.
........@.@......@...@....@.@.
.@.@..............@..........@
.................@@......@....
....@.........................
@.....@..@.@@.....@.@..@...@..
...@...@......................
@..........@..................
..........@...................
........@..@..................
...........@................@.
...@...................@......
............@..............@.@
........@.....@....@..........
.........@@.............@.....
......@...@....@...........@.@
...@..@@...@..@...............
..............................
...................@..........
.@.........@........@..@...@@.
.@.....@...@.....@.........@..
@..@..............@...........
..............................
..........@.....@.............
.@.....................@......
.......@.......@..............
.@......@...@...............@.
