30,30
...@......@..@......@.....@...
........................@.....
@.......@...........@.......@.
.............@...@..@.........
..@..................@...@@@.@
...@..@...@..@................
........@...@......@..........
............................@@
@@...................@........
.......@.........@@@....@@..@.
.......@......@......@........
....@................@........
.......@..@.....@@@..@..@...@.
........................@.....
...@.@........................
..............@..@.@...@.....@
....@.@..@..........@.........
....................@..@......
......@.......................
..........................@...
..............................
...............@.@.......@..@.
.......@.@..........@...@.....
..............................
............................@.
..@.@..........@....@.@.......
....@.......................@.
......@.........@.....@.......
....@........@............@...
...................@..........
