30,30
....@...@...@.@.........@.....
.@@......@....................
.....@..@...@..@.........@..@.
.................@.........@@.
.@......................@.....
...@..........................
.............@................
...@..@@.@.@....@.............
..............@.............@.
..........@.....@.............
...@.....................@....
.......................@...@..
..............................
........................@@....
.....@.....@........@......@..
......@..............@........
@.@...........................
@.................@.@.@@.....@
.....................@@.......
.....@.......................@
.@....@...@..@............@...
....@...@..@..................
@...................@.........
.........@.......@............
..........@...................
@......@....@..........@...@..
.....@@.@...................@.
......................@....@@.
...........@..................
.....@.@...@..@..@.@.@....@@..
