30,30
.@............................
...@.......@.....@.@...@......
..........@.@.@......@........
...@...................@......
...@............@@.......@@...
...@....@.......@.....@.......
.................@............
......@........@............@.
..............................
..@..........@...............@
........@.@.........@.........
..@...........@.@......@......
...........@...@@.........@...
.......@..............@......@
..............@.........@@....
.............@...........@....
....@.....@...................
@....@...@..@....@............
..............@....@...@......
...............@..@....@......
.........@........@...........
.....@.....@.....@........@.@.
..@@...............@...@......
.........@.@...@..@...........
.....@........................
....@....@...@.........@......
.@@..@...@...............@.@..
....@......@..................
...............@........@.....
..............................
