30,30
..................@........@..
...@........@.........@.......
.....@.........@......@......@
..@..@@.......................
.........@....................
.......................@......
@..........@..@.......@.......
....@...@.@......@............
.....................@..@..@..
.@.@...@.....................@
........@...........@.........
.....@..............@..@......
..............................
....@.@......@.........@......
......................@....@..
.@@..@.....@..................
...@..........@...............
.....@..@......@..............
.......@.........@.........@@.
.................@............
.........................@....
...@...@....@..........@...@..
...@@..@.............@.....@..
@@.............@.........@....
.........@......@....@........
......................@.@.....
.....@@...........@@......@...
..@..@...........@@.........@.
@...@.......@.................
................@@...........@
