30,30
...............@......@.......
@.@...@..@....@@@.............
....................@.........
......@.@..@................@@
....@...@...@....@@...........
....@.....@.....@.............
.@...........@..@..@..........
..............................
..@.....@.@@..........@.......
..............@...............
.........@...@..............@.
......@.................@.....
..................@...........
@........@...@...............@
......@..@.........@..........
...........@.@................
..............@.@.......@@.@..
.@.......@.........@..........
.............@...@............
..........@............@..@.@.
............@.@.@......@......
.........@.@...@......@....@..
.........@.......@...@........
.@.......@....................
........................@..@..
......@.@..........@..........
..............................
.......@..@...................
...@@......@..................
.....@......@............@...@
