30,30
....@..@@....................@
@@@......@.@..............@...
............@........@.@.....@
....@@.............@@.........
......@..@....................
..........@@........@..@......
......................@......@
..........@.....@....@@.......
@...@.....@.................@@
.@....@........@@.............
................@.............
........@......@..............
....@.........@.............@.
.........................@@...
.@......@..@@...@.............
...........@......@.....@..@..
.....@.....@.........@........
............@...........@.....
.@@.......@...................
...........................@..
..........................@...
........@.@.@......@......@.@.
.......@..................@...
.............@...@.......@....
...@......................@...
....@....@...@.....@..........
....@..................@......
....@...........@............@
..........@...............@...
..............................
