30,30
..........................@...
.......@........@.......@.....
@.............................
...@...@......@.......@.....@.
@.@...............@.......@...
.......................@.@...@
..@............@..............
...@...................@..@...
...........@....@.............
..@...........................
.@@.......@.....@.......@@....
...@@.........@..@@......@....
.............@......@.@.......
........@.........@....@......
...@........@.................
...@..@@...........@..........
..............................
.....@..............@.@.......
..@.............@..@.@...@@...
................@............@
....@...@..............@......
......@.......................
.@....@@........@............@
@...............@.........@...
@........@@..........@........
...@..@.......................
......@..@..............@.....
..@.....@.....................
..@......................@..@.
@....@...........@....@.......
