30,30
.....@....@.@.....@...........
......@.................@.....
..................@........@..
.....................@........
...@..........................
...@......@...................
@....@...........@@.@.........
........@....@...........@....
...@.....@......@..........@.@
..........................@@..
.@...@@.......................
...........@..................
..........@@........@.........
.........@@..........@........
......@...........@........@..
@.@...@.@.....................
.@.@................@....@....
...............@..............
.@....................@.......
....@........@..@.@...........
...............@...@..........
@..................@........@@
.........@.@..@...........@..@
.....@.....@...@@@.......@....
........................@.@...
......@...@..@....@@.......@..
..............................
..........@.........@.........
....@.@@.....@................
........@...@......@.....@....
