30,30
...................@@.........
.@..............@............@
..............................
..........@@............@.....
........@........@............
.....................@......@.
........@............@........
.....@...@..........@@@.......
....@.....@@@.........@.......
...@.......@.@..@.............
...........@......@..........@
.............@..@............@
....@...@.@...@...............
....@........@..@@.@..@......@
.....@......@.@.@.........@...
............@........@........
...@@....@.@@.................
..................@.......@...
..........@..............@....
................@......@......
.......@...............@.....@
..................@.@@..@....@
............@......@..........
.................@@.@........@
....................@@......@.
@@.......@.........@......@...
.....@....@...................
......@........@..............
............@.................
..............................
