30,30
@.........@..@@...............
..............@...@@.......@..
...@.....@....................
...................@.....@....
..........@.........@....@..@.
..............@......@.@......
..................@...........
...@.@......@.........@.......
...............@..@........@..
........@...@..........@......
...@..........................
.......@..@..@...........@....
........@......@...........@..
@@.............@...@.......@..
............@.........@.......
@.....@............@..........
.....@..@..@...@..............
.....................@........
......@@...@.........@@.......
.......................@......
..@.@.......@......@@....@....
.......@............@......@..
..............@....@@.........
.@....................@.......
....@.........................
......@...@.........@.........
..................@........@..
........@..............@......
.....@......@.@..@............
....@.....@....@.........@.@..
