30,30
.......@@@...@...@............
.@@......@..@.................
..............@..............@
...................@.....@..@.
..............@...@..@........
..@........@....@............@
.@.........@..............@...
@...............@.......@..@..
...........@...@..............
.............................@
.@...@....@.....@.........@...
.@@@@.......@..@...........@..
..@.@.....@...........@.......
......................@....@..
..@...........@...@@..........
.........@.............@.....@
.......@.....@................
.................@@....@....@.
........................@.....
.......@...@......@...........
...........@.@..@@............
................@@...@.......@
.......................@......
..................@....@......
...............@..............
..............................
............................@.
........@..........@..........
......@.............@...@.@...
.@........@.@.@.......@.......
