30,30
.............@................
............@.....@.........@.
@@........@......@.......@@@..
...@@........@..@.............
...@..............@...........
................@.....@.......
....@.......@............@....
..@......@......@.........@...
..................@....@......
.@................@...........
.@.....@......@............@..
....@...............@.........
...@.......................@..
..@.........@........@....@...
@.......@.......@.............
.......@......................
..............@.@@............
................@.........@...
@..@.@@............@..........
....@.........................
..............................
............@.@.....@...@..@..
...@.......@..................
...@....@............@........
...@........@@................
..@@...@................@.....
......@.@......@..........@@..
@...@...................@.....
........@.....@.@.........@...
....@..@..@..............@....
