30,30
.......................@......
......@@@..........@..........
............................@.
.....@@...@........@@.........
..@...@.....@.@...@......@...@
.....@........@..@............
@........@............@@......
............................@.
.@....@.@.......@.....@.......
...@..........................
.@...............@............
......@......................@
....@....................@...@
..@...........................
........@@.......@@@...@......
...@.............@........@..@
......................@.......
...................@....@@.@..
.@............................
......@.......@.........@.....
.....@........................
...@.............@..@.........
.......@................@.....
..@.......@.@.@@....@...@.....
.@@..@...........@............
...@@@........................
....@..@..@............@@.....
..@................@..........
...................@..........
............@...@..........@..
