30,30
.............@................
...@@............@............
....@.....................@...
@@...@...@@............@...@..
............@..........@......
@.@@...........@...@..........
............@............@....
.................@...........@
..@...............@..@........
................@.......@@....
......@.@..........@...@......
.....@@..........@............
........@.@.......@...........
@.....@....@..................
................@...........@.
..........@..@.....@..........
......@........@..............
...@.....@.@..................
.@.....@.@...@@@........@...@.
.....@...........@............
@.....@..@....................
..............................
............................@.
..........@...........@.......
.@............@.......@.......
......@.........@.....@.@.....
............@............@....
.....@@@........@...@.........
@............@..........@.....
@....@...@.......@............
