30,30
@.@.@.........................
....@.....@...........@.....@.
.@......@...................@.
....@.........@....@.........@
@......................@......
..@..........@..@.............
......@@................@.@..@
....@.@...@@.@.....@.....@....
.....@......@......@....@@....
...@...@.............@....@...
...@.@..................@.....
@..@..@......@................
...@@............@..@.@.......
..........@.................@.
.....@.@.@....@.....@.....@...
..............................
................@...........@@
............................@.
..................@...........
........................@.....
...@..........................
.........@...@@.......@.......
....@.........@.........@.....
................@..@......@...
..............................
............@.............@...
.@................@....@......
.....@.....@@......@..........
.........................@....
...........@......@...@.......
