30,30
..............................
..@.........@.............@.@@
.........@..@....@....@.@.....
.......@......@........@.....@
.@..@.........@.......@.......
..............................
...........................@@.
...............@......@.......
.....................@........
...@.........@..............@@
........@..................@..
............@.................
.........@..@.................
.......@.............@........
.........................@@...
..............................
.......@......@@..............
@......@...@..@...@...........
.@...........@......@.........
...@...........@..@....@@.....
..............................
.........@...................@
....@...@.@.............@....@
.......@@.......@....@........
....@.@@...@..................
.@....@.........@.@.......@...
.@@..............@............
@@..................@@........
.....@..@.@........@.....@...@
......@..@....@@..........@...
