30,30
@.............................
......@.................@....@
................@....@...@....
..............@.......@.....@.
.........@....@.............@.
@....@@.........@.............
.........@.@..................
.@............@...@...@.......
.@............................
..................@...........
...@....@..........@.......@..
...@.@....@............@.@.@..
..................@..@@....@..
...............@@@............
................@........@@...
...@..............@.......@...
..@...@...............@.......
.......@.@..........@...@...@.
......@.......................
.@....@.......@......@........
.....@...@.....@.......@.....@
..............................
..@@.....@.......@.......@....
..............@@.......@......
....................@.@......@
...............@..............
.......@@...........@.........
...........@.......@.....@...@
...........@@...@............@
.............@................
