30,30
...@...@....@.....@...........
...@.................@@@......
@..............@...@....@.....
..@.....@@........@.....@.....
....@.@.......................
.@...@@.....@...@.....@.......
................@.............
....@.........................
..@.....@..@..@........@......
...@..@@...........@..........
............................@.
..@...........................
........@@....@@@.............
...............@.@.@..........
.......@...................@..
.......@.@@..@.....@..........
..............................
............@.@...............
.................@............
......@........@..............
.........@@..........@@.......
........@..@............@...@.
.....................@........
.........@...@...............@
.....@.................@......
......@...@...................
@.@..........@..@............@
.@..@.................@@..@...
..........@....@..............
@.@.............@...@.........
