30,30
..............................
.....@..........@...@@..@.....
..............................
..............................
@...@..@...@..@@.@.........@..
....@........@................
............................@.
.@.....@........@.............
........@.............@...@...
......@..............@@.@....@
..............@...@..@........
..@..@................@.......
..@.........@@..........@.....
@.....@............@@.....@...
.......@.....@....@...........
.......@..@........@.......@@.
....@...................@.....
....................@.........
.....@......@..@..............
.....@....@............@......
...........@..................
.....................@....@...
.......@......@....@.....@....
.........@...@....@.....@.....
................@.............
.@............................
.....@................@.......
.....@.@...........@...@.@.@..
.@..@........@@....@..........
..........@....@.@.......@.@..
