30,30
....@@....@@..............@...
....@............@............
...@..........................
...@............@.......@.....
.................@@........@..
.@...@.@.................@....
..........@...@.......@.......
.@............@......@........
.......@........@.............
.....@.......@...........@..@.
.............................@
.....................@........
...........@@...@.........@@..
...................@.........@
....@...................@.....
@@....@...@..@...@..........@.
............@..........@......
@.@......................@....
.......@......................
....@....@..............@....@
@..........@............@@....
.............@........@.......
...@.........@................
.....@.....................@..
...........@..................
..@@............@.............
...........@.......@@.@...@@..
.....@..@.......@....@.....@..
.......@@............@........
...@............@...@.......@.
