30,30
.....@....................@...
@...................@.@.......
.@.............@.@........@..@
........@.......@.........@..@
..@...........................
.....@................@.......
@...........@......@.@........
..............@...@.@.........
........@..@.........@..@.....
.............@..........@.....
.@..@......@.@....@..@....@...
.........@....................
....@................@........
...............@...........@..
.@............@..@........@...
.@...@.@............@.........
.@.............@...@..........
..............@...............
.......@..........@...@@.....@
...................@@......@..
......................@.......
...........@@......@..........
@................@...........@
.........@......@.............
.......@.@..@...@.@.........@.
....@........@...@..........@.
....@..@......................
..@........@.........@...@....
.......@........@......@......
..............................
