30,30
............@.................
.......@..@..@....@...........
....@....@@...@...............
...............@.@..@.........
.....@..@........@@........@..
.....@...........@.........@..
.@....@....@.....@......@.....
.......@...........@..........
..................@...@.......
......@......@...@..........@.
.......................@......
.@........@.............@.....
..............................
..@...........................
............@.................
.@..........@....@.....@......
.........@.................@..
......@....@.........@....@...
.@.......@..............@....@
..............................
................@............@
....@...@.............@...@...
.@.....@@.....................
....@.......@.................
...........@...........@@..@.@
....@..............@.........@
....................@.........
.@...@.......@..............@.
..........@..@.@@...@@........
@.......@.@@.......@...@@.....
