30,30
.................@.@.....@.@..
........@...@@................
...........@........@.......@.
.......@@..@........@........@
.........@......@......@......
.........@.@....@.............
...............@..............
.....@.......@@.@.......@@....
............@.............@...
..........................@...
....@@......@........@........
...@...@.@....................
.....@....@.@.........@.....@.
..........@...................
.......@.....@..@.......@.....
.................@.....@@.....
..........@...............@...
..@.@............@............
.........@...........@........
...........@.......@......@.@.
......................@....@@.
.........................@....
....@...@@.@..@...@...@@......
..............................
@.@..@.................@....@.
.@......................@.....
.............................@
.@..@........................@
.......@..................@...
.@........................@..@
