30,30
@@..@...........@.............
............@...@..........@..
.......@......@......@..@.....
.....@.@.............@.@..@..@
.......@@.......@.............
..........@..@................
..................@..@...@...@
..................@.@..@.@.@@.
@.........@..@...@............
...@...@......................
......@@...................@.@
....@......@........@.........
..............................
..............................
@.......................@.....
........@.....................
..@......@....................
.........................@....
...@.......@.@......@...@.....
........@....................@
...@@.....@..................@
.@....@.......................
.....@..........@.....@......@
.@@.........@...........@.....
..............@.@.........@...
.....@.@@.......@......@......
..........@........@........@.
....@....@....@..........@....
....................@.........
....@...............@.........
