30,30
......@.......@.........@.....
....@.@.......................
.@.....@...............@....@.
.......................@......
....................@..@....@.
.................@............
.@............................
......@......@........@.......
@....@...@....................
...............@....@........@
...........@.............@....
.....................@......@.
.......@@.....................
.@.....................@......
........@.....................
.........@........@...........
...@.............@........@...
...@........@..@........@.....
..@....................@......
........@.@...........@.......
....@......@.....@....@.@.....
.........@@.....@.........@...
..@.@..@.......@.........@....
...........@................@.
..@..........@.@..@@@..@@.....
..@@..........@....@....@.....
...@.........@....@.....@@....
...@....@........@.@...@......
..............................
@.......@.@.@.................
