30,30
..........@...................
......@....@.......@.....@..@.
.............@..@..........@..
...................@..........
.........@..@..@..@@@.........
......................@.......
...@...@..@.....@.....@.......
.......@.................@....
@....@....@.@......@.@.@......
...........@..........@@......
..................@......@....
..@...............@...........
.@..............@.............
.@..@...@.@@.@.....@.........@
....@......................@..
........@.....................
....@@@..@.......@............
@..................@....@...@@
............................@.
..@...........................
..............................
..............................
....@.@........@...........@..
......@....@.@.......@...@....
....@........@.@..............
@...............@..@@.........
..........@..@....@........@..
..............@.....@.........
.................@............
..................@@...@.@....
