30,30
....@.......@....@............
.....@.......@..@.......@@....
.@..@.......@............@..@.
@.......@....@........@.......
.....@........@.@.............
.........@...............@....
..............................
.....@.........@..........@...
..@....@...........@......@..@
...@..@.@..@..................
.....................@........
........@..........@........@@
........@.....@.@.............
......@.......@..........@....
.......................@......
..@.....................@..@..
........................@.....
.@..@.......................@@
.......................@......
.@........@........@......@...
..@.......@...............@...
.......@...........@.........@
.@.........@................@.
.....@..........@.@......@....
................@....@........
........@......@.@.......@....
....@.@............@@.........
@...............@.............
.............@................
.........@..........@..@@@....
