30,30
.....@........@@.........@..@.
.....@........@......@.@.@....
.@........@..@..........@....@
..............@............@..
..............................
......@......................@
.....@......@........@@.......
.....@.@.....................@
.........@..@...@.............
..........@@..@...@...........
.........@......@.............
.......@...........@..........
...@.@..............@..@......
.....@........................
....................@......@..
..........@......@............
@........................@....
........@.........@...@.......
................@....@..@.@..@
..@...........................
..........................@...
....@......@...@..............
......@..@.@......@.......@...
....@..@......................
..........................@@@@
@....................@........
...@@@@...................@...
............@....@.......@....
.@.........@................@.
...@..@........@@..@..........
