30,30
@.@.......@.............@.....
......@.@.....................
........................@.....
........@...................@.
......@........@@@..@......@.@
............@@....@....@......
........@.@..........@.@......
...........................@..
..............................
........@.............@..@...@
...@.......@...@......@...@.@.
..........@...@..........@..@.
....@...............@.....@...
..............................
.......@@.....................
..........@..............@....
......@........@.............@
.....@.........@..............
...@.....@.......@......@.....
..@..@................@..@....
...........@..............@...
.............@...........@....
.........@...........@.@..@...
.@@........@.......@..........
...........................@..
.................@.@......@...
.@@..........@.@.@....@.@.....
...............@.............@
.............@.......@...@....
@....................@.......@
