30,30
.............@..@.............
...@....@.............@.......
......................@.......
.............@...@....@@......
........@..............@..@...
@......@....@...@.............
.......@.....@.............@..
..........@................@..
.@....@...............@...@...
...............@...@....@.@@..
...............@..@...........
...........@..................
..................@...........
.................@............
...@....@......@........@...@.
...@...@....@..........@......
..........@....@.........@...@
@................@............
.......@...................@.@
@............@.......@........
.....@..........@............@
.....@..@..@.................@
.....@.......@....@@@.........
.........@..@............@..@.
......@...@..@......@.........
@........@...............@....
@............@...@...@........
..............................
..@..@.........@........@...@.
.........................@....
