30,30
...@..@.....@....@........@...
................@.............
.@...........@@......@........
...@..@..............@.......@
@..@.......@...@.........@..@.
......@..@.@.@..............@.
@.@...................@.......
.........@....................
..@@..@.......................
@..@...@@..@............@.....
.......@........@......@.....@
...............@..............
...@...........@.@........@...
..@.@@........................
.................@...@........
............@..@..@...........
.............@.............@..
@..........@..................
.........@.................@@.
.........@..........@.........
..............................
..............................
.....@......@.......@......@..
.................@...........@
....................@......@@.
...@......@.@...@.@.@.......@.
.@...@.........@@.........@...
.............@..............@.
............................@.
.....................@@.......
