30,30
...................@.@........
....@..@...@.....@@@..@....@..
...........@@.....@..@...@.@..
..............@...............
@............@@..........@....
...................@........@.
..@.................@.........
...@........@.......@.........
.@...@......@.........@@......
....@.........................
.@.........@...........@......
..@...........@....@...@......
..............................
...........@..@.......@.......
.@............@.............@.
......@..@....................
.@.@...................@......
................@.............
..............................
.@.@.......................@..
...@....@.....................
........................@.....
.@.@................@....@....
.........@...@......@.....@...
............@@...@............
@..@...@.....................@
..@.......@@@.@.......@@......
@....@........................
............@.......@.........
.@...@.....@.......@@.........
