30,30
.....@...................@....
..@.....@......@@...........@.
............@.....@..@..@.....
..................@.@@.@@.....
................@........@....
..............................
........@....@................
...................@.....@.@.@
..........@@........@........@
..@.............@.....@.......
..................@........@..
..@@.......@..@@...........@..
..@.@.....@..@@............@..
....@.@.....@......@@.........
......................@.......
..........@.@@.......@........
............@.................
@........@@...............@.@@
..............................
........@.....................
..............@...............
.@..@....@....................
..............................
..........@........@..........
..@............@@.............
..........@...@......@.......@
....@.........@.......@...@...
.........@................@...
.@..........@@........@.......
....@@..@@....................
