30,30
.@@.....@@.........@@.........
..........@..........@.@......
....@..@....@..@..@....@......
.........@......@.........@...
.........@....................
...................@..........
....@..................@....@.
.....................@@.......
...........@......@.@.......@.
.@.........................@..
..........@......@......@.....
...........@..............@..@
..............@...........@@..
@......................@......
...........@..@.@.............
....................@......@.@
......@.......................
......@.@..........@....@.....
................@.............
@....@....@.@.......@...@@....
.....@@............@..@@......
...@.....@.@.@.......@........
..............@.@...@.........
........@.....................
..@..........@..@..@..@.....@.
............@..@..............
..............................
..............@.....@.........
....@.....@.....@.....@.......
........................@.....
