30,30
.@....@.@....@................
................@@@....@.@...@
...@...@..........@@..@.......
.@....@@.....@.............@@.
................@@..@@....@...
......@.@........@.......@..@.
........................@@....
....@............@............
@.......@........@....@.......
........@....@......@.........
.............@.@.......@......
.............@................
.......@....@.......@........@
....@.........................
...@@@.......@..@.....@@......
.......@...............@......
.......@............@.........
....@.........@.....@@....@...
......................@.......
..........................@@.@
.@..@.........................
............@...@........@....
.....@...........@.@.......@..
..............................
..............................
..............................
..........@............@......
.............@................
......@..@.................@..
@.............@.@......@......
