30,30
...@........................@.
...@.....@.........@..........
@...........@.......@.........
..@........@@.....@.@......@.@
.@.........@..@.......@@....@.
......@.......................
.@.............@.@..@..@@.....
.@..@...@...........@.....@...
................@.............
.....@......@...........@..@..
@.............@......@........
....@@.....@......@...........
.@..@.........................
@.....@@.@......@.............
............@@...@.@.......@..
..............................
........@................@....
@.......................@.@..@
.......@@.....@...@.........@.
................@.............
..............................
.@....................@....@..
......@.....@.@...............
........@.........@...........
.@..................@.........
................@.......@.....
........@...........@........@
....@.@...............@.......
.......@...........@.......@..
..............................
