30,30
................@@............
........@@..@.....@...@.....@.
.........@.@..............@...
.....@.@........@.........@...
......@.....@....@.....@..@...
...@.@...@@.........@.........
@.@....@.......@..............
.@...................@@.....@.
..@@........@.....@.........@.
.............@.@.......@......
.........................@....
.....@....@..@................
......@..@.....@.@......@.....
............@.................
...@.......@..................
............................@.
.......@......................
.........@@.................@@
..............@...............
.........@..@@................
@..........@.@..........@...@.
.....@.@.....@...@............
....@.................@.......
..............................
......................@.......
.@..............@.........@...
...@@............@@...........
............@@.@..@......@....
........@.....................
....@................@........
