30,30
.@.........@@.........@.......
....................@...@.....
.............@................
..........@...................
.......@@........@....@.@.....
.@............................
.............@.............@..
..........@..................@
..............@........@......
............................@.
.......@..@.....@...@.........
....................@.........
..@...@@@.@...................
.....@.................@......
...@..@............@..........
...@.....................@....
......................@.....@@
...@..............@@.....@.@.@
...........@....@.............
@.@...@..@........@..........@
..@.@@....@....@.....@........
......@.............@..@@.....
................@.............
@...@.........................
.............@..@@...@........
.....@......@......@..........
.........@..@..@......@.......
......................@....@.@
......@........@.......@@.....
............@..@......@......@
