30,30
..@.......@......@@..@....@...
....................@..@@..@..
...@......@.@.................
..................@....@...@@.
..................@...........
......@.......@..@..@........@
@..............@.@.@......@...
..@...............@...@...@...
............................@.
...@..@.......................
@@......................@....@
.......@.........@...@........
.......@...........@...@.....@
...........@..................
..........@............@......
.......@....................@.
@......@......@...............
.......@......................
@...@...............@.@.....@.
@..........@.@............@...
..............................
......@........@........@.....
......@...............@..@....
...@......@..@..@........@@...
@......@..@...................
............@.................
..................@.........@.
......@.............@@........
................@.............
.@.@..@...@...................
