30,30
............@..@..............
...........................@..
....@.........................
.............@..@.....@......@
..........@.@.................
..@........@@..........@..@..@
.@.....................@@.@...
.........@.......@....@.......
.@........@@......@@......@...
......@.........@.........@...
...........@.@...............@
..@.@.........@...............
..............................
.............@........@.....@.
..........@.......@...........
...@..........@..@..@.........
.@......................@.....
.................@...@....@...
....@.@.....@.....@.....@.....
.@.@..@@...@.....@............
....@...@.@@............@.....
...........@.......@..........
..........@@....@.............
....................@.........
......@..........@.........@..
....@..@....@....@.........@..
..........................@...
@.................@...........
.........@.........@......@...
.....................@@.......
