30,30
............@......@..........
.............@.@..............
...........@........@.........
..............@....@..........
.......................@......
.............@...............@
..........@...@......@...@@...
......................@.....@.
.........@...@.....@...@......
.........@....................
..@...@..@.....@........@.@..@
..................@...........
...@.@@........@@.............
...@.........@......@.........
..................@.........@.
..........................@..@
.........................@....
.......@...........@..........
..@.@...@........@............
.@.@.....@.............@@..@..
........@......@..@@....@.....
@..@............@.............
..............@..@.@...@......
.........@..@.................
..................@@..........
........@..........@.......@..
.@..........@....@.......@....
.@.@....@.@..@................
.....@.............@.....@....
.............@...........@.@..
