30,30
.....@....................@@.@
.........@...@....@...........
............@..@.........@....
..@..............@...@..@.....
...................@..........
..@..@@......@@....@....@.....
..@...............@...........
@...@........................@
...@.@...@.........@...@..@@..
@.......@.....................
@.....@.@.....................
.@.............@..@..@..@.@...
..............@........@...@..
.....@.......@..........@....@
.......................@.@....
.........@@......@...@........
..@.............@............@
..............................
.......................@.....@
......@.@..@....@.....@.......
.@..@.@.......................
........................@.@...
................@@...@.......@
..................@...........
..........@...................
..............................
.............@................
.@.@@..........@..@...........
..........@@..@..............@
.........@....................
