30,30
.........@...@@..@.......@....
................@......@......
......@...@...............@...
........@......@........@.....
@.@............@........@.....
......................@...@...
...@....@.....................
..@........@...@@....@.......@
...@......@...................
..@.............@.@...........
.......................@......
........@@......@.@@@......@..
@...@..@...@......@.....@.....
................@......@......
.................@............
..@.......@..@................
.................@...........@
........@@..........@..@@.....
...........@.@.........@.@....
.@..@.........................
..@@@......@..................
.....@....@...@.......@.......
.........@................@...
..@...........................
..............@.@.......@.....
........................@.....
@.....@@......................
.......@..............@..@@...
.@....................@.......
@.............................
