30,30
..@...........................
..@.......@...................
.....@.................@....@.
....@........@......@..@......
............@.................
..@.@.@.@...@.................
........@.....@@@.......@.....
...@.......@............@.....
..........@...@..............@
........@.............@.@@....
...........@..................
.@.@.@.....@..................
............@.........@.......
..........................@...
...@................@.@......@
................@........@....
.......@@..........@.@@..@@...
@..............@....@@........
...........@......@....@......
..........@.........@.........
@.....@.......@....@..........
.......@..............@...@...
@.........................@..@
....................@.........
......@.............@.........
.....@.@@..@......@...........
.............@................
...@...................@@..@..
......@..............@........
...............@....@..@...@..
