30,30
......@.@........@............
..............................
......@.@........@............
........@............@...@....
@.....@.............@.........
..............................
............@.@.@.........@...
..............@@@.......@.@@.@
.....................@.....@@.
...............@.......@......
........@......@.............@
.........@..........@........@
..@......@...............@....
..@......@@.....@.@.@.........
...@....@.........@...@.......
.............@...@............
....@....................@....
.............@..@.....@@...@..
...@.....@.........@....@...@.
.......@.....@....@..........@
@..@...................@......
.@.........@......@..@..@...@@
.........................@@...
.....@....................@...
......................@.......
......@........@..@...........
.@...........................@
................@.............
@......@@.....................
................@.............
