30,30
@............@................
..................@....@......
.....@...@................@...
......................@.......
@@............@.........@.@...
..@.........@.....@......@....
..........@.@...@.@..@........
.@.........................@..
....@@.......@....@...........
..@...........................
...@.@...............@.....@..
@..........................@..
......@....@..............@...
........@..............@......
..........@.........@.@@....@@
.....@...........@............
.....@@............@@.@..@..@.
..@............@........@.....
.....@...@............@.......
..........@..............@....
.....@....@..........@........
...............@....@.........
.......@@.......@.............
...............@.@............
....@.........................
...@.........@.....@...@....@.
........@...@...@...........@.
...........@@.....@..........@
...........@........@.........
....................@.........
