30,30
..@....@............@.........
..................@.......@...
.......@.....@...........@....
.............@@...@...........
@.........@...................
.......@.......@........@.....
..@..............@.....@......
.....@........................
..............................
..............................
..@......@.............@....@.
..........@.....@..@@.@.......
...@.........@..........@....@
...........@..................
......@.....@.@.@...........@.
.@...................@........
.............@.......@....@...
......@......@...............@
..@....@.....@@........@...@..
...@..@........@@........@...@
..............@...........@...
...........@......@........@..
@............................@
@...@...............@...@.@...
.@..@..........@..@....@.....@
.@......@.....................
........@.....................
....................@..@...@..
.........@@...................
..@.....@........@@@..........
