30,30
.@....@..@.........@..........
.........................@.@..
.....@.....@@.......@@....@@..
.............@....@........@..
.............@........@.......
.@.@............@..@...@.....@
............@.................
........@.....@..@.......@....
.@...@..@..@.........@........
.@............................
......@......@............@...
..............@..@............
..........@...........@...@...
.@.......@......@..........@..
.............@@............@..
.......@...............@@.....
................@..........@..
........@............@........
..........................@@..
@.....@........@....@.........
..@.................@.....@...
@..........@...............@..
.............................@
...........@..........@....@..
....@...@.....................
..............@...........@...
...@@........@.....@......@...
....@...................@..@@@
.................@@...........
.........@....................
