30,30
.....@..@...@.....@..@........
....@.......@..@..............
...@..........................
..........@...................
................@..........@@.
..@...........................
..@.@.....@...................
.................@..@.........
...@......@....@.@............
.......@...........@..........
@................@...@........
....@..@.....@.....@..........
@.....@...@...................
.....@.......@@.............@.
....@..........@...@..........
............@....@...@..@....@
............@.................
.......@.........@............
.......@......................
......................@.@.....
..@..@..........@......@......
...@@....@................@...
...@...........@@.......@.....
.@.......@.................@.@
@.......@.....................
...@...............@@.........
................@.@......@..@@
.....@..@....@....@......@...@
........................@...@.
@..........@........@.........
