30,30
.......@....................@.
.@.@..@......@...........@....
.......@...........@@.........
@.............................
.@.@.................@.......@
...@........@...@.............
......@.......................
@......................@......
..........@......@.....@@..@..
......@....@..................
............................@.
................@.......@.@...
.............@.......@........
......................@....@@.
....................@......@.@
.....@......@.....@.......@...
......@.....@..........@......
.........................@....
..............@...........@.@@
.......@..............@@......
.@.@..........@...............
.....@..@..@@.........@.......
...............@.....@...@....
....@@.@......................
.....@..................@.@...
............@................@
....@..@@....@......@......@..
...@..........................
..@............@..@...........
..@@......@.@.............@..@
