30,30
...................@..........
......@.......@...........@...
......@...@.....@.............
.@...........................@
.@.@@......@..................
........................@....@
.....@..............@@......@.
.....@@........@..............
..........@..................@
.........................@.@..
.....@....@.......@...........
.......@....................@@
.......@......................
..@@............@.........@...
...........@...............@..
.........@.......@.....@......
.@...........@..@.....@....@..
........@.....................
......@..............@........
..@........................@..
...........@........@@......@@
@.....................@..@....
@...........@..............@..
...@.....@.....@.......@......
.@.......................@@..@
@@....@........@.@@...........
..........@@..@..........@@...
......@......@.........@......
....@..............@..........
.....@...@...........@........
