30,30
...................@..@.......
....................@..@......
..............................
.........@....................
......@..........@........@...
................@....@........
....@...@......@..............
...@.........@....@...@.......
.@.@.................@...@....
.@.@@..@..@...................
......@@.....@.....@..........
.......@....@.........@.....@.
......@.@...@.................
................@.....@@......
...........@..................
..................@.@@..@..@@.
...@..@................@......
.........@..................@.
..@@............@.@.@.........
.....@...........@..@..@......
.@....@.......................
..@.....@.......@@....@@......
...........@@....@............
@..@@.........................
........@.....................
........@........@..@.........
...........@...............@..
....@@........@...............
.......@.......@......@.@.....
.....@.@......................
