30,30
......@.......................
.......@....................@.
..........@...............@...
.....@.@..................@@..
.....@...@....@......@@......@
...............@..............
.......@.@....@............@.@
....@..........@@..@..........
...................@....@@....
.....@....@.........@.....@...
..@...@.........@@@..@....@...
....................@.........
..@..@....@..........@........
.................@@...........
............@.................
@@.....@......@.........@..@..
@..................@.@........
..................@.........@.
..@.@........@............@...
..........@..........@....@...
......................@.......
@..@@...@.@...................
.........@.....@..@@.......@..
..........................@...
...@........................@.
...@.............@............
..........@...................
....@............@....@@......
..@..................@......@.
...........................@..
