30,30
...........@...@..............
..@.@......................@..
....@....................@....
..........................@...
......@..................@....
...@.@........................
.............................@
..@..........@...@............
...@..........@............@@.
.......@@..@..................
@.@...........@...@@..........
.@..@...........@............@
..@....@......@..@............
......@....@..................
....@@.....@........@...@..@..
.@......@....@................
.......@......@...............
.......@....@..........@......
.@....................@.....@.
..........@...................
..@.....@........@........@...
..@.....@....@..........@.....
...............@.........@.@..
..........@..@......@......@..
....@.@.....@..@..........@...
..............................
..........@.....@....@......@.
.............................@
.....@................@.@@....
........@@.@.@...@............
