30,30
@..................@.......@.@
.@...@.......@....@@..........
........@..@.....@............
.......@....@....@@@.@.@......
......@...............@.......
....@............@....@.......
.@@.....................@.....
@..............@@.............
..............................
............@.................
......@.......................
@@..@....@....................
@.........@@.............@....
........@.@...............@...
...........@........@.........
....@.@@..................@...
@............@....@@.......@..
............@.................
...@..........@....@...@.@....
......@@.@...............@.@..
.........@........@...........
@.........@.....@....@........
........@..@..................
.............@................
............@.......@.........
..................@.@.........
.@..@@.........@.......@......
@........@............@.......
..@.@.........................
.......@....................@.
