30,30
.......@..@.............@.....
@@..@.......@........@.@......
.....@.............@@......@..
......................@.@.....
........@........@............
.......@..@....@....@........@
..@....@.......@......@.......
..............................
....@...@..............@......
..@........@............@....@
.....@....@...........@.@.....
.................@..@.........
.....@....@.........@.........
.@..@.........................
.@.....@.....@..@....@....@...
@..........................@@@
..@.@.........................
........@...........@.@...@.@.
................@.............
......@......@................
..@......@..........@@....@...
@........@@...................
..@...........................
.........@....................
....................@.@@......
.................@..@@........
..........@.........@.....@...
...@..........................
...@............@@............
....@...........@..@..........
