30,30
.....@.@@......@........@...@.
............@.................
.................@............
.........@...........@..@.....
.............@..@..@.........@
.@............@@.............@
..........................@...
.....@...@.@..........@.......
.......@..................@...
.@.................@......@..@
......@.....@@................
....@....................@....
.......@......................
....@.......@.................
...........@................@@
.@.........@@.................
.....@.@..@.@..@..@@@.........
..@......@....@..@............
................@...........@.
...................@...@...@..
..........@.@.................
......@....@.......@....@@..@.
......................@...@...
..............................
..@...@........@@......@..@...
.................@..@.........
..........@....@........@...@.
........@.....@....@..........
................@.............
......@......@@...............
