30,30
.@...............@............
....@....@...........@........
.@....................@.......
..................@.........@.
.................@............
.@.....................@......
..........@..........@......@.
...........@..............@...
.@............................
...............@.......@......
......................@.......
@@.......@........@..@@...@...
..@........@...@..............
.......@.........@..@.....@...
@............@...@@@.....@....
.@@@...@......................
.......................@.@....
.................@@........@..
......@@.................@...@
.........@....................
@........@........@..........@
......................@.......
.@......@....@.......@........
...@............@....@...@.@..
.@..@..@..@...............@.@.
..@@............@.......@.....
.............@................
............@@......@...@.....
@................@............
..................@...@..@...@
