30,30
...................@.....@....
........@.....................
...@.................@......@.
...........@......@...........
...............@....@.........
..@...........@..@.....@@.....
@.....@..@......@@...@........
...@.......@..............@.@.
...@.@.....@..................
.......@......@..............@
...@.@...@.@@..........@......
..............@...............
........@.....................
...@@.......@..@..............
...@@@...................@....
...@.......@................@.
............@.................
..@.................@@....@...
.@..@.........................
.@...............@......@.....
..............................
........@.....................
..............@.@@.........@..
..............................
.....@........@...............
......@........@..@...........
@..@...................@....@.
.........@.@...@...@.........@
..........@......@@.@...@.....
..@@.@....@.@.........@.......
