30,30
.........@.............@@...@.
..@...........@@..............
......@.......................
..............@...............
.........................@....
..@........@..................
.....@...................@@...
...........................@..
.@.................@........@.
..@......@....................
........@.@...................
...@......@@..@..........@....
.@..............@@....@...@...
..................@@.@........
@...@......@..@.@...@.....@...
@...........@@...........@@.@.
...@...@...@..@...@.@.........
....@...@.....................
..............@..@.......@....
@.@........@..............@...
@................@....@..@.@..
.....@...........@............
..................@...........
@........@......@.............
.....@.....@..................
..............@..............@
@......................@......
.@.............@@..@....@.....
........................@@....
.................@...........@
