30,30
..........@...................
@.........@...................
....@....@.....@@.@...........
......@........@...@..........
@@.......................@.@..
....@....@....@..@.@@....@.@.@
.............@................
....@...................@.....
...........@................@.
...@.@........@...........@...
..............................
........@....@......@.........
..........................@...
..............................
..@..@..........@.............
.......@......................
.@.@...@....@............@..@.
........@............@....@...
.@...@........@..........@....
..@......@.......@@..@....@...
....@.........................
.....@@...@...@..@....@..@.@..
@.....@..................@....
..............@.@.............
...@...................@....@.
................@.....@.@.....
........@.....@......@........
.....................@.......@
@........@.....@..............
...@........................@.
