30,30
......@..@.......@.......@....
.....................@........
.......@.............@..@.....
@.............@..............@
...@..@..@....................
.....@.............@.@...@....
.........................@....
............................@.
........................@.....
.@..@@.@...............@......
..........@@@........@........
@.@.............@.............
..@...@@......................
.....@......@...@.............
..............@@.@.....@......
.@....@@....@......@..........
...@.@..........@....@....@...
........@....@............@...
...@.................@...@....
...@..........................
......@............@..........
..............................
..@.....@.....................
...........@@@..............@.
.@.....@........@.............
...........@.....@........@@..
...@.........@..@@.....@......
......@............@.........@
.......................@......
@......@.@..@...@...@.........
