30,30
..@..........................@
.......@.............@........
...@....................@.....
............@.....@.........@.
.@.........@..................
.......@......@....@..........
..............................
.....................@....@@..
..................@.@........@
..@....@...@@.....@......@....
..@.@.@.@................@..@.
.................@.@.....@....
..@...........@...@......@....
.@............@@...@...@......
.......@....@...@@............
..@........@...@@.......@..@..
...@..@.......................
........................@.....
..............@...............
..@........@..................
.........................@....
......@@..............@..@@...
.......................@......
..........@.......@...........
.@.........@..@............@..
...@.@......................@.
@......@.@.................@..
..............................
.@........@.....@..@.......@@@
.@......@..@..................
