30,30
.............@@............@..
..@.....@..........@@......@..
....@@..................@...@.
.@...@.@.....@@........@......
...............@..............
.....................@....@...
............@.............@...
....@.@...@.....@....@.....@..
........@@.@....@.............
.@..............@.............
@......@.........@.....@......
..@........................@..
@.@...........................
.........@.@@....@............
...@.@..............@.........
..@................@..........
......@................@....@@
.....................@.@......
.@..........@@....@...........
....@......@........@.........
..........@@..................
............................@.
.@........................@...
...........................@..
.......@@........@.........@..
..@.@........@....@......@....
.@.@..@....................@..
...@.....@@...................
........................@.....
..................@......@....
