30,30
..........@.@...@.@......@....
..............................
....................@.@@......
@......@.................@.@@.
.......@........@@.....@...@..
......@.......................
...@....@......@..@....@......
.........@..........@.........
@......@.....@.....@.....@....
.............@.@@@............
....@.......................@.
........@...........@.@@......
...@@.................@@......
.......................@......
.@.......................@....
.......................@......
........@.......@........@....
.....@..........@@............
..@...........................
..............................
.@.@.@......@...@....@...@....
.....@.........@...@..@..@....
....@......@.................@
..@@......@..@................
.....................@........
................@...@.........
@....@....@............@......
..........................@...
......@....................@@.
@@.........@................@.
