30,30
...@....................@.....
....@....................@@...
............................@.
...........................@..
...@@...................@.@...
.@......@......@@..@...@......
..@......................@...@
....@@......@.................
.....@...@..........@...@.@...
.........................@....
......@.@.......@@.....@@..@.@
........@.....@...............
@.........@@...........@......
.............@......@.....@...
....@........@...........@@...
.........@..@......@..........
.........................@....
@.@............@..............
.........@........@.....@.....
.........@.@..................
....................@........@
..............................
...........@@....@............
..............@.....@@@@.@....
.@............................
............@.................
.....@.......@................
..@......@....@..........@...@
....@..@.@.....@.....@........
........@........@.@..........
