30,30
.......@........@.....@.......
.....@..............@.........
.....@........................
......@...@@..@........@......
@...........@...@......@@.....
............@@.........@......
..@...........................
.................@@....@..@..@
.@.......@..........@.........
......................@......@
....@.....@@..................
..........@...................
........@....................@
......@.....@.......@.........
....@..............@.....@.@..
....@......@..........@.......
...@..........................
@.................@...........
..........@...................
@...........@.@......@........
............@.@.@@............
...@..........@..@...@..@.....
...............@..............
.........@..............@.....
@...@@......@...........@.....
............@...@.@.......@...
............@................@
.........@.@..@.@..@..........
@......@..............@.@.....
..@........@.....@....@.......
