30,30
.@....@.....................@.
.............@......@@...@....
.@............@..........@...@
@......@...............@.@....
......@@.........@............
...@...@......................
........................@....@
..............................
.....@.................@.@....
.@............................
.....@............@.......@...
@.............................
.......@.....@......@.........
..........@.......@..@...@....
......@.......@........@......
.............@....@@......@...
.............@..@.....@.......
..............@.@@..@.........
..........@@.@................
.............@...........@..@@
.@..@.....@...................
...........@...@............@@
@.......@.....@...@...........
...........@.@@@..............
......@..@@.........@.........
....@.....@..@@...............
................@.............
.......@.@....@.......@.......
.......................@......
..........@....@..........@...
