30,30
.@............................
.@.@............@........@....
....@...@.....@........@.@....
.................@............
@@...............@.@..........
.@...........@.@....@.........
...@.......@.@.@....@.......@.
...@...............@....@.@...
..............@.....@@....@...
.....................@........
................@.............
..............................
.@.........................@..
.@...............@............
@...@@@..............@.@......
.................@.@.@.@......
..........@...................
..@.@..@..@...........@.......
...............@..............
..........@...................
..........@.........@.....@...
.....@.......@.......@........
.@...........@....@........@..
.....@...............@..@..@..
....................@.....@.@.
..............@..@.@..........
.....@@..@.......@........@...
.....@.......................@
...@.................@........
...@......@...@.@.............
