30,30
......................@..@..@.
.....@........@....@..........
.......................@......
.......@................@.....
....@....@..@.................
.......................@....@.
.....@.@.@.......@............
..@..........@......@@........
......@.@.@..................@
.....@@.......................
...........@.....@........@...
....@.............@....@......
.......@......................
......@.......@....@.@........
..................@.....@.....
..................@...........
@......@......@@@@.......@....
.......................@......
............@.................
......................@.......
@..@.......@..............@...
@..@@.........@..@.......@....
................@.............
.....@...............@..@.....
..@...........................
..@..............@.....@......
.......@...........@@.........
@.@......@.....@@.@@...@....@.
........@............@........
......@...@..@.@......@...@...
