30,30
...................@......@...
...@.@.@................@..@..
.....@..@.....@..@............
....................@......@.@
..@...................@.....@.
..@...@@......................
....................@...@.....
.......@..............@..@....
@@..............@.....@.......
....@....@...@................
................@............@
..@...................@.......
....@...@.........@..........@
.......@......@@........@.....
....@@........................
................@...@...@.....
@..@.....@..@@................
..@...........................
.@......................@.....
........@..@.........@........
.............@......@.........
......@...........@.....@.....
..............@....@..@.......
....@..........@..............
......@.............@..@@@....
@.@.............@....@........
.@@.@...............@.........
..........@.@.@...............
..............................
....@@............@........@..
