30,30
.....@..@....@...@............
...........@.............@@...
...........@..............@...
.@........................@...
.......@.....@....@.@.........
..................@.@.........
.......@........@@..........@.
..............................
.@.............@........@.....
......................@.......
...@.....@@.@.................
..@..@.@@..@..........@.......
..@...........@..........@....
....@..................@.@....
........@......@..............
...@........................@@
...@..........................
..@...........................
.....@..@.....................
.@............................
@..@......@...................
@@@...@.......@.@@.@..........
............@.............@..@
..............@...........@...
..............@..@............
...@..@..@.............@......
........@..@...@..............
.....@......@.@@@.............
....@........@....@..@.....@..
@..@..@...@...................
