30,30
........@...........@......@..
..@.....@...............@.....
......@.......@..@...@.@......
.@@..@..@.....................
@..@.@....@....@..............
.@.@.................@........
....@.........................
...@....@....................@
@.@..........@......@.........
.....@...@...@...@.........@..
...@..........@...@......@.@..
............@.........@...@...
....@.......@.@@.....@........
............................@.
@............@....@@.@........
@.......@.....@...............
@..@.@........................
.................@...@........
..................@.@.........
@........@....................
.............@.......@...@..@.
..@...........................
....@......@@@.......@........
..........@........@..........
.....................@........
.......@.....@..@.............
..............@..@...@........
.....@.......................@
..............................
...................@.@........
