30,30
......@.@.....................
....@@........................
@...........@............@....
...........@@..@..@...........
@..................@@......@..
...............@..@@.@........
.@.@...................@......
..............................
................@.@@..........
.@@..........@..@.@...........
@.....@.......@..@...@@.......
..@..@.........@..@...@.......
.......@..@.@.............@@@.
@@.....@................@.....
..............................
.................@............
.....@..@...............@@.@.@
...............@..............
....@.........................
.............@.........@......
..............................
.....@........................
.@....................@.......
@...@.........................
...............@@.@.......@...
....@...@....@..@.............
.....@............@..@...@..@.
.....@.@.....@................
...................@..@..@..@.
..@...................@..@....
