30,30
@@..........@..@......@.......
.............@....@@.@........
@@........@......@............
...@..............@.@@.......@
.............@...@.......@....
.......@.@...@................
...@...@......................
..............@...@...........
.......@@........@............
@..........@...@.....@........
....@...........@.............
..............@@..............
.............@.....@.......@..
...@..........................
@.....................@...@@..
..............@..............@
...........................@..
..............@............@..
.......@@...........@.....@...
.....@........................
..@...@.....@@..............@.
.........@@..................@
....@@.......................@
.......@..........@...........
.@@................@..........
.....@@.......................
....@..................@......
...............@...@.....@@@..
....@..................@......
.@.............@....@@..@....@
