30,30
...........................@..
.......@......@...@......@....
....@..@......................
....................@.@..@....
.............@................
...@..........@.@.............
......@......@................
.......@.........@..@@........
.@..................@......@..
....@.................@.......
.................@......@..@..
@....@..@..............@@.@@..
..@@..........................
...................@.........@
...............@.@..@.....@..@
..............@...@..........@
...........@............@....@
....@........@.............@..
........@.@@.......@...@......
.......@......@........@......
..........@..........@.@......
@....@....................@...
............@...........@.....
..@.......................@...
..@...@.......................
.@.....@.@...........@.......@
.....@..........@@............
...........................@.@
@.............................
.....@@@.....@......@.......@.
