30,30
............@.................
..@...........................
..............@@......@......@
..@.........................@.
.@........@....@.@............
...@.................@...@....
....@.....@.............@...@.
..........@....@.....@....@...
...@............@.............
..............................
..........@........@........@.
...@......@.....@....@........
......@....@..................
.....@..@..................@@.
...@@.......@.................
.........@.....@........@.....
....@@....@.....@@............
......@.@..@..................
..@.....................@@..@@
.....@......@@................
..................@...........
@.@@.....@@.....@....@.......@
...............@@...@@.....@..
..............................
..............@...@......@....
...............@..............
.......................@......
.......@@......@.......@....@.
........@....@................
...@.......@..@@..............
