30,30
.......................@......
.@...........@................
.........@....................
............@.................
........@.......@@........@..@
@...@................@........
@.....................@@.....@
..@.@.............@......@@...
...........@...@.........@..@.
..@.......................@...
....@............@..@.@@...@..
...........@.....@.......@....
......@...........@@....@.....
..........@...@@.@.@..........
................@@.......@....
@...............@.......@.....
.@.............@..............
......................@@......
...........@..@....@@@@.......
...............@..........@...
..............................
.@....@.......@.............@.
..@..@...@........@......@....
......................@....@..
......................@.......
...................@......@...
...........@........@@......@.
..............................
....@........@.........@......
............@@.....@......@.@.
