30,30
...@..@@..............@.......
.....@.......@.....@..@.....@.
..@...........@......@....@...
........@...........@..@......
@........@..@..@....@@........
...................@........@.
...........@..@.....@.........
.................@..@@........
@....@...@.......@.....@......
......@...@....@.@@...@..@....
....@.........................
.............@........@......@
.@......@...@...@.........@...
..@...............@...........
......@......@.......@........
.....@...@..........@........@
....@...........@.............
.........................@....
@......@.....................@
...@@..............@@.........
.............@......@....@...@
............@.........@.@...@.
......@......@................
....................@.........
........@.........@...........
.....................@........
.........@...............@..@.
..............................
..............................
..@..................@.......@
