30,30
.......@.....@..@.............
.@.@@....@....................
..........@.....@.......@@@...
@..............@....@........@
......................@.......
....@........................@
.....@....@...............@.@@
......@..@....................
......@................@......
........@@...............@....
@....@....@......@@...........
...........@.@..........@....@
.@.........@.....@.@..........
......................@.......
......@...............@..@@@@.
..................@@.....@....
..@...@.......@......@..@.....
..........@.........@.........
.....@.............@....@.....
.....@........................
..@..@@.......................
.......@......@..@............
.............@..............@.
..............................
........@......@..............
...........@....@..@..........
..@@.@.@......................
.........................@....
.....@.........@......@...@...
....@.....@......@............
