30,30
@...@@.......@................
........@.................@...
................@@@...@.......
@..@........@..............@..
...@....@.......@....@........
........@@.....@..............
............@......@@.......@.
.............@............@...
....@...@................@...@
...@.....@..@....@............
.......................@......
............................@.
...@....@.............@.@.@...
.........@............@.......
..@.........@.................
.....@......@...............@.
................@.........@...
.@.@...@......@...@...@.......
....@...@..@.......@.@..@.....
@....@......@.................
.@..........................@.
.@@...........................
.@..........@.............@...
.........@..@.............@...
..............................
..........@.................@.
......@....@.......@.....@....
.........@....................
..........@..@....@.........@.
..@........@.........@........
