30,30
.....@.........@@..........@..
......................@.......
...@.....@...............@@...
@..@..........................
@@............................
@..........@@..............@..
..............@....@....@.....
........@........@............
.@............................
....@@..........@...........@.
.................@............
...........@......@...........
.............@.....@..........
@....@.@........@...@.......@.
...@@...@...........@.........
.................@.@...@......
.@................@.@...@.....
...........@.@................
...........@............@@...@
......................@@......
..................@...........
..........@..@@@.......@......
............@......@.......@..
...............@@.....@@.....@
...................@..@....@..
...............@..............
.....@............@.....@.@...
...@..@.......@...@...........
@........@....................
.......@..........@.......@@@.
