30,30
.....@...............@...@.@.@
.....@@@....@...@.............
.......@...........@@.........
...........@..................
@.......@....@................
@.......@.....@@......@.....@.
.@.......@....@.@..........@..
.............@............@...
..@.......@.....@.............
......@...@...................
.....@.....@...@..............
............@.@...@.........@.
..@.........@......@..........
.....@...................@....
.........@....................
............................@.
@....@.......@.............@..
.@......@............@........
..............................
......@@...........@.....@.@..
..............@........@......
.@............................
.@....@........@..@...........
...........@..@.....@.........
.......@...........@.@@.......
.......@..@..@....@...........
....@......@........@.........
................@.............
.......@..........@@....@.....
.........@.....@.............@
