30,30
........@.........@..@...@...@
.......@..@.............@.....
.............@.....@..........
@..@...@......................
............@@.....@@.........
....@..@...@...@..............
..............@......@........
..@.........@.@@........@.....
.............@..@...........@.
.....@......@@....@....@......
.....@...@.@...............@..
....@............@............
......@.....................@.
.....@........@.......@.@...@.
.............@................
...........@............@.....
@.....@.@............@........
@.@.@.@....@.....@......@.....
......@@...@......@..@........
...................@..........
..............................
.............................@
..............................
..............................
......................@....@..
.....@.....@.............@....
.....@..................@.....
.............@...@............
@.........@...@..@.@.....@....
..@@................@@..@.....
