30,30
.@..@.........@...............
........@.............@.......
...@....@..........@..@.....@.
.....@.....@....@........@....
..........................@.@.
@..........@...@....@.......@@
.....@.....@..................
..@.............@..........@..
..............................
....................@..@......
...........@.@..........@.....
......@.......................
.@.....................@..@...
............@.....@@.....@...@
..............@...............
..@...@....@...@@............@
........@........@............
..@@@.@....................@..
....@.@.@@............@...@@..
....@..@....................@.
......................@....@..
...............@....@..@......
.........@....................
.............@..@.....@.......
.@......@..............@......
@.......@........@............
.@...................@....@...
.......@.........@.@..........
....................@.........
........@.....@.@.............
