30,30
.............@.........@......
.......@...................@@.
......@.@.......@@...@.......@
@.......@...@...@........@....
............@@................
....@.........................
..@....@................@.....
....@....@....................
..@...........@.@....@........
....@...@........@...@....@..@
..............@.....@....@@...
......@..@.@.............@....
........@......@@.............
......................@.......
....@.......@....@............
...@...@..............@.....@@
..@...........@...@...........
........@..@...........@......
.....@..........@...@.........
.....................@..@.....
............@....@.......@..@.
...........@.@................
........................@.....
..@..........@..........@@....
...@..........................
.................@...@.....@..
..@..@@..@...........@........
...........................@..
......@.................@.....
.........@..............@.....
