30,30
......@................@@....@
.......@.....@.......@......@.
......@........@..............
..@......@...............@....
..............@...............
..............................
..............................
..@....@..@.........@...@.....
....@.....................@@@.
..........@.@..........@......
.........@............@.@.....
@................@......@@....
.....@..@.....................
@...........@....@.........@..
..............................
....@......@......@.....@.....
.....@......@......@..........
.....................@@@......
..@..............@@...........
......@...@.........@.@.......
@...............@....@@..@@...
..............................
@@..@.........................
.......@..@....@.@............
.............@...@............
......@.@@..@....@...@........
..................@@.....@..@.
......@.......................
@...@.........@........@@.@...
........@...........@.........
