30,30
..........@............@......
....@....@..@.................
...........@...@.....@....@..@
@.....@...............@.......
...@...@.....@................
.........@@.@..@........@.....
.@..@.@...@..........@......@.
.....................@........
.........@......@.......@.....
@...@.........@..@.....@..@@.@
.....................@........
@......@.@.......@.....@......
........@.....................
..@...........@.........@.....
.....@@@@............@......@.
...................@.........@
..............................
.................@....@...@...
@.........@...................
...@........@..........@......
.......@......................
@.@.@.......@.................
.............@..........@.....
...............@...........@..
..................@...........
...@....@....@...@............
..........................@.@.
..........@...................
.@..@........................@
........@....@.........@.@@...
