30,30
....@@@.......................
..............@..@.@..........
.......@.@................@...
...@.................@....@...
.....@.@.....@.......@.......@
..@...@.................@.@...
...........@..................
..@.......@......@.....@......
..........@...................
.@..@.....................@.@.
....................@......@..
....@......@.@................
.@............................
..................@.....@.@.@.
...........@.@................
....@......@.............@....
@............@........@@......
......@...@.......@......@....
........@.....................
@@......@...@.................
...@........................@.
..@..@....@....@..............
.................@.........@..
................@.............
........@..@......@...........
......@...@...................
@....@.....@......@......@....
..................@.@.........
.......@...@......@@..........
.....@@..@............@..@..@.
