30,30
...........@..@.........@..@..
@......@....@.................
............@.........@......@
.@@@.....@.......@............
...........@......@..........@
..............@............@..
.@............................
@........@......@..........@..
...@..@.........@..........@..
.............@.@..............
.............@..........@.....
@........@..@.@.@.............
............@....@............
....@...........@.....@.@.....
@....................@.@......
........@...@@................
..........................@...
.......@@....@................
@............................@
.....@.......@@.....@.........
...@...........@........@...@.
.@.......@.......@............
............@.@@..............
.....................@........
..........@.......@@..@.......
@.............@.........@.....
.......@.....@..........@.....
..............@....@@@.....@..
..........@.................@.
....@............@............
