30,30
.@..............@....@@......@
.......@....@.................
.@..........@@....@...........
@......@...................@..
.......@..............@..@...@
...............@..............
.@......@..@.@................
........@..@..................
.....@...............@........
.....@...@....@.....@.........
...........................@..
@....@@@.................@....
........@.....................
....@.........................
.......@.@.................@..
.....................@...@.@..
.@..................@.........
...........@@@................
@.....................@....@..
................@.@...........
..@...........................
@@@.@.........................
...@........@.................
.@................@.@.........
.@..........@...............@.
...@..............@.....@.@...
..@.......@..@...........@...@
....@.....@...................
........@.....@@.........@.@..
......@...@@@@.......@........
