30,30
@.............@........@@.....
...@..........@.......@...@...
...@..........@........@.@...@
..@@..................@.......
......@........@@......@@.....
...@..@.@....@................
......@........@..@...........
..............................
.@.@..........................
..@....@.......@............@@
................@..@..........
......@@.......@..@.......@...
..........@......@...........@
.....................@@..@.@..
.@..........@.@.............@.
....@@...........@............
........................@..@..
....@.....@...@......@........
...........@.........@....@...
..........@@...@...@..........
.........@..............@.....
..........................@...
......................@.......
...........@.................@
.....@......@.................
...........@.....@..........@.
..........@......@............
...@@..........@..............
....@..........@..............
...........@......@......@....
