30,30
.........@.@..................
.................@@..@....@...
..................@.@.@.......
...@......@....@..............
..........@................@.@
........@.@...@.@.............
..............................
........@...@...........@.....
..@...@........@..............
...........................@@.
...................@.......@..
..@............@....@....@..@.
@........@.@.....@............
.@...@..@........@.@..........
............@.....@....@......
.................@............
.............@....@..@..@.....
..........@...................
....................@.........
........@..............@......
........@......@.@............
..@........@@..........@..@...
..@.@.@................@......
..........@.@@.@.......@......
.@..@...@...............@.....
........@........@.....@...@..
@@..............@....@...@....
.............@...........@....
@@............................
..........@...................
