30,30
.......@..........@.....@@....
..........@.............@@....
.......@......................
........@.................@..@
.................@.....@......
.......@..@..@...@..........@.
.@..@...............@.@....@@.
................@.....@...@...
...........@.......@..........
.............@................
................@.......@@@...
..............................
...........................@..
@..........@@...@.............
............@......@....@.....
.......@......@..@.......@....
@.........@...@...@.@.....@...
.........@.............@...@..
......@.......................
..............................
...@.@...............@........
@.@...@....@...@@............@
..............................
..@..@........@...............
..@.....................@.....
....@.................@...@...
.....................@.....@..
.....@..........@......@.@.@..
@...@......................@.@
...@.....@@...@...@...........
