30,30
................@...@@........
.@..@..@@@.............@..@..@
@@...@.@......................
.......................@......
..............................
@.......................@.....
...@.................@........
.@..........@@..@...@.........
.....@............@@..@...@..@
.....@@.............@........@
....@...@...........@...@.....
....@..@...........@..........
....@................@........
..@...........@.........@.....
........@.....................
..@...@........@..............
...........@..@...............
..............................
...................@.@........
......@.....@................@
........@.....@..@.........@..
@......@.....@................
.....@.....@............@.....
............@.@..............@
.........@...@.........@......
......@...........@...........
..@@.....@.........@.......@..
......@................@@.....
...@.................@.....@.@
..@...........@...............
