30,30
.......................@@.....
......@....@.............@....
......@...................@...
.@......@.@..@................
.@.@..@.@......@..............
............@....@@.......@...
.......@.....@...@....@.......
..............................
.........................@....
..........@......@............
.....@...........@.........@..
@..............@..............
@.......@.....................
.........@....................
...........@........@..@......
...........................@..
........@...@@......@..@......
...@......@..@.............@..
....@.........................
@.@.....@...............@.....
..................@......@...@
................@....@.@@.....
....................@.........
.@..@...@@..@...@.@@...@......
.....@........................
..@@.......@@...@.@.......@.@.
.@.........@...@.....@....@...
...........................@..
......@............@....@.....
.@.........@..................
