30,30
.............@................
@...............@....@@.......
.......@.................@....
...@..........................
........................@...@.
...............@..@..@..@@....
......@...............@@......
.....................@........
.........@...@...@............
@........@@...@@.@.........@..
..................@.......@...
..@.............@..@@...@.....
......@@............@.@.@....@
...............@........@.....
..@................@..@.......
.................@..@...@.....
........@.............@.@....@
.......@......@.......@.....@.
.........@....................
...........@..................
.@......@.....................
.....@@.......................
............@...........@@..@.
.......@....@....@..........@.
........@.......@.............
...@........@....@.@....@.....
..............................
..............@.@@............
.@.@.....@@.....@...........@.
............@.@...............
