30,30
.......@...............@.....@
...........@..................
....@@........@..@........@...
...............@@........@....
............@.................
@....@..............@..@...@..
................@.............
..@..................@........
..@...@.@...@......@..@.....@.
...@...............@..........
...............@..........@...
...........................@..
................@......@@.....
.........@@.@@.@....@........@
......@...@..@................
..........@...................
@.......................@...@.
.......@..@........@......@...
...@......@...................
.....@....@..@....@...@@......
@..........@.....@..@......@..
...@.....................@....
@.................@.@.........
...@..........@...............
....@.@......................@
@..............@..............
....................@.@@.....@
.......@......@...............
...............@.......@....@.
...............@..........@...
