30,30
.......@.@...........@........
@.............................
.......@.................@....
..............................
..@...........................
...@...........@...@......@...
............@.................
.........@.@@..@...@...@......
.....@.@......................
.@..................@@........
....@.........................
...@..............@..........@
.........................@....
@.......@...@..@.........@....
...@.@........................
@.@..................@........
............................@.
..@.@@.............@........@.
............@............@....
.......@.....@.....@@.........
.......@..........@@..@...@...
.............@.@...@........@.
...............@...@..........
......@.......@.......@.......
@@...@....@@..................
..@......@...............@....
.@..........@@...@@.....@.....
.....@@..@......@@............
..........@@..@......@........
..@.@...@.....................
