30,30
@......@.......@.......@......
.@@..................@..@.....
.......@....@.@@.....@........
.@.@.....@...........@@.......
...............@..............
.........@...........@........
.....@........@...............
......@...........@...........
..........@....@..............
.......@.....@............@...
..............................
@...............@....@.@......
..............................
..@....@.................@....
.................@............
.......@.............@........
@.....@....................@..
................@.......@@....
...@.......@..................
....@......@.....@......@.....
....@....@.....@....@.......@.
....@..@..........@...@..@.@..
........@..............@......
....@.@....@......@.....@.....
...........@........@.@.......
.@........@..@.........@......
.@..............@..@..........
.....................@....@.@.
...@..........................
..@@..@...@..........@.....@..
