30,30
....@...@...........@.........
......@..@....................
...@....@.@........@..........
.................@......@....@
....@.........................
....................@.........
.....@....@...@......@........
..@......@...@..@.....@.......
.........@@...@.......@@......
.@....@..@.............@.....@
..........@.@...@...........@.
..........@......@............
.........@............@...@...
@..@....@.....................
@..@....@.@...@............@.@
........@.@...@@............@.
@..@....@@.@..................
.............................@
@.......@...........@.........
......@.......................
.@.@......@...@......@........
..................@........@..
....@........@................
..............................
.....@......@........@........
..................@...........
..........................@...
.................@....@...@..@
......@............@.....@....
.............@.........@......
