30,30
..@.@........@...@.....@.@@...
........@........@....@......@
........@..@..................
...................@..@.......
...........@...........@......
...............@..........@.@.
..............@....@...@@.....
....@.........................
...........@@.......@.......@.
........@..@@..@...@....@..@..
.@..@.................@....@..
@.....@............@..........
.....................@.....@..
......@..@...........@........
..........@.......@...........
................@........@....
....................@.@.......
@...........@..@..............
...............@@.............
....................@.........
.@....@............@...@.....@
..........@...@.............@.
............@@.....@@..@......
..@.......@..............@....
...................@.....@....
.....................@.@@.....
.....@....@.....@.........@...
..............................
@........@....................
.....@.......@.........@......
