30,30
.....@........@.....@.........
..@..@........@..........@....
...........@.................@
...@................@...@....@
....@.............@..@.......@
@@.......@@......@............
..@..........@.......@........
............@.................
..............................
.......@..@.@.@..........@...@
...@..@..@...........@........
..............@.......@.......
..........@@......@.@@.@..@...
................@...@.........
@.......@.......@...........@.
.@....................@.......
............@.................
....@.............@...........
....@............@..@......@..
.......@..................@...
@....@..@.........@......@....
..............................
..............@...............
........@................@....
..........@.................@.
...@...@...@..................
....@..@.........@@...........
...........@.....@.......@...@
...@.@....@................@..
.........@.....@............@.
