30,30
..............................
.......@.@....................
..@.@...@....@.......@........
...........@.@...........@....
......@......@..@.......@.....
....@.@.................@.....
..................@..........@
...............@..............
........@......@.@............
@.......@..............@.....@
.@........@..............@.@..
......@.@.........@@...@......
.@.......@.......@..@.........
@.......@.....................
......@.......................
...@........@..........@@.@...
.@............................
...@.......@...@....@.........
..@......@.........@@.........
.....@..............@..@......
.....@...@....................
..................@........@..
...........@..............@..@
.........@...@...........@..@.
....@.....@...................
....@..........@..............
..............@.....@...@....@
@........@@..................@
....@............@..@...@.....
.@@.....@.....................
