30,30
@.........@......@...........@
.@.@.@......@@.......@........
....@.......@........@@...@...
..............@...........@...
.......@........@.............
..........@....@..............
..........@........@..........
....@.@............@..........
..@.@.......@....@@...@.......
............................@.
...@.......@...........@....@.
..@....@......................
@..@.@.............@.@........
..@..@.........@.........@....
................@.............
..............@...............
.........@.......@..........@.
.............@.........@......
.........................@.@..
....@...@....@@.........@.....
......@.....@...@....@........
...........@..................
.....@...@..@.................
...........@.......@..@.......
........@.....................
..............................
.@.............@..............
..............@.......@...@.@@
..........@..............@....
@..@...@@.............@...@@..
