30,30
.......@@.....................
...@....@..............@...@..
@............................@
......@........@.@............
........@...........@.....@...
...................@..........
..@.@.........@...............
....@.....@...............@...
.......@......................
.....@........................
..........@................@..
....@.@...................@...
.@.....@.........@...@.@......
..@..............@.......@....
..@.@.@.@..................@..
............@...@@............
.....@........@...............
.................@@.@.....@..@
.@..@.....@...................
@..@@@.......................@
@...@................@.@@.@...
......@.............@..@....@.
......@....@..@.@.............
..............@............@..
..............................
@@........@..........@@.......
@......@.@................@...
....@.........@...............
.......................@..@...
....@....................@....
