30,30
.....@.@.@....................
....@.........................
..............................
.@...@...................@....
.......@..........@...........
........@...................@.
....................@........@
.............@.@..@...........
.@............@...............
........@@......@...@.........
@......@...@..@...............
......@.......................
......@...@....@@.............
@...........@..@...@..........
....@....@.....@..............
..@.............@.@...........
.....@.................@..@..@
................@.............
..........@.....@.........@...
.@......@.............@@..@@..
@................@..@.@.....@.
.@..................@......@..
...................@@....@....
......@.....@.........@......@
........@.....................
@................@....@@......
.......@@.@...................
......@.....@.......@.@....@..
.........@.@@.........@.......
.@.............@.....@........
