30,30
..........@......@.....@......
..........@.@....@......@....@
..@......@...........@........
@....@.........@........@...@.
.............@..........@.....
...............@@.....@.......
.....@..@.@........@.@..@..@..
.............................@
.....@............@......@..@.
@......@...@.@................
..............@......@..@.....
........@.....................
....@.........@...............
......@.........@..@........@.
@.@..........@......@.........
...@....@.....................
.........@..@.............@..@
@@@....@......................
.........@....................
..............................
@....................@........
......@...@.......@...........
@............@.......@........
....@..........@.............@
.............................@
...........@..............@..@
............@...........@...@@
...........@.................@
....@@@.......................
@...........@...........@...@.
