30,30
....................@...@.....
.......@.........@....@.......
....@..@............@......@..
....@................@........
.@.@.........@.....@..@.....@.
...........@..................
..............................
.@........@...@...............
.....@..............@.........
...@...@.........@.@..........
...@..........................
.........@....................
..@.........@...@........@....
...............@....@.........
..........@......@............
....@@@.....@.................
..........@.......@@....@@.@..
...........@..@..@......@..@..
................@....@........
........@....@.........@......
.......@....@.....@.@........@
.................@.@..........
...@.......@..............@...
....@.@...@@..........@.@...@.
...@.................@....@...
..............@....@......@.@.
....@.@....@..................
...........@......@...........
...@..@..................@....
.............................@
