30,30
........@.....@........@.....@
.....@.......................@
..@.@...@.....@....@..........
.......@.....................@
..............................
....@...@....@.@@..@....@.....
.....@@.....@..@..............
.......@..........@..........@
...............@............@.
.................@........@...
.............@................
........@.@.............@.....
.............@....@...........
......@....@..................
.@....@..@....................
..........................@...
...................@@......@..
@...@@.............@..........
...........@..............@...
@...................@.........
...@...................@......
..@...@.....@.................
....@...@...........@..@.@....
..@...@.@..............@...@..
.@.........@.................@
@.........@.........@.........
@...@.....................@..@
......@...@...@.......@.@.....
..@...@..................@....
.........@...@............@...
