30,30
..@..........@..@.............
...................@..........
.....................@........
....@...@.....................
....@.......@.................
@..@....@.................@...
....................@.........
............................@.
.....@..@@............@.......
...@..@.....@...............@.
.......@...@..@..@.....@......
.........@...@................
...@......@.....@.........@..@
.....@........................
@...@.@........@..........@...
@..@...........@...........@..
............@.................
@.....@.....................@.
@.........................@...
.......@.................@@...
........@.@.@..@..............
@....@.......@.........@@...@.
...................@.@......@@
........@...@.................
.@..@@............@..........@
........................@.@...
..........@..............@.@..
......@.....@.................
@...........@.................
............@......@@.@.@..@..
