30,30
..............@@....@........@
....@...........@..@@@.....@..
...............@...@..........
......................@....@..
..@..@.......................@
.....@..........@.@.@.........
.............................@
......@.......@........@......
.........................@....
.@.......................@....
.......@..........@........@..
................@.............
..@.........@@..@@.....@@.....
..............................
....@.@.@........@...@....@...
....@.....@.....@.....@@......
..@...............@..@........
.........@.......@...@........
@.....@........@.....@........
.........@.@...........@......
...@..........................
............@.......@...@.....
...............@..@...........
...........@......@...........
.@............@...........@...
....@..@................@..@..
......@...............@....@..
.....@.....@...@@..@......@...
..........@.@.......@.........
..............................
