30,30
...@.........@................
...@.....................@....
...@.........@....@...........
@.......@..............@@.....
............@@..........@.....
........@.....................
......@.@........@............
.....@@.@..........@.........@
..........@....@@.............
..........@..@........@.......
........@......@@.............
..........@..@........@.......
.......@....@..............@..
.....@..@.....@.........@..@..
............@........@........
..........................@...
........@.....@.@.....@.......
.@......@...@.........@.......
.@...........@.....@.......@..
.@.....................@......
...............@.....@........
......@.............@@@.......
...@@.@.......................
..@..@.......@@.@......@....@@
..............................
............@............@...@
.............@...........@....
........@.....................
........@...@.@...............
.........@..@.@............@..
