30,30
...............@...@.........@
.....@.............@.@........
.@............................
.@....@@........@...@........@
....@...................@...@.
..@.@.@.............@....@....
............................@.
........@@.@.....@........@..@
.@.................@..........
....@...@........@.@...@.@....
@........@....................
................@..@....@.....
@@.........@............@.....
..@.....@.....................
..@.@.......@.......@@........
........................@.@@..
..@....@..............@.......
.....@.....@..................
.............@...........@....
..@..@........................
...@.......................@..
.......@....@.....@...........
@......@.......@@..@..........
.......@.............@........
@.............@@............@.
......................@.......
.....@.......@.@............@.
@.......@.....................
.........................@....
............@.........@.......
