30,30
@.@@..............@.....@.....
.................@.......@....
........@....@@.......@.....@.
..@........@..................
.@......@..................@..
.@...........@..........@@@..@
..............................
.........@....................
........@.@...@...............
........@....@...@.@...@@.....
....@.........@.@.............
@......@.....@......@..@@.....
.@....................@...@...
..............................
..@......@....................
.............@...............@
@.......................@.....
@...................@.........
.............@.@@@...@........
......@@........@@............
.@@......................@....
.............@................
.......@...........@...@@.....
....................@.........
..................@...........
.......@..........@....@....@@
.....@..........@.....@...@...
..@@.@.......................@
....@.........................
..@@..........@..........@....
