30,30
@..................@.@.....@..
..................@...@.......
........@..................@..
.......@......@...@@...@@..@..
..........................@@..
..............@.......@..@.@..
.@..............@...@.@.......
..........@.......@@..........
@........@.@...@...@..@...@@..
..@..............@..........@.
...@..........................
.......@...................@..
@@............................
.@...@....@@....@...@.........
..........@..@....@.@.@....@..
..@.......@..@................
..........@.....@....@........
...........@..................
..........@.....@.............
..@............@.............@
.....................@........
..................@...........
.....@............@.@.........
..@...@......@......@......@..
.............................@
...@.@.........@..............
..............................
......@.@....@......@.........
.@.........@......@..@........
..............................
