30,30
....................@....@@...
.....@..@........@.....@......
@.@.........................@.
......@.......................
..........@.............@.....
.......@....@.@........@@..@@.
........@........@...@..@.....
@.............@.....@.....@..@
.............@................
........@.....................
...........@...@............@.
...@@..............@.......@..
....@.....@...................
...............@..............
...........@.......@..........
..........@.......@.......@...
@...@...@.................@...
.......@..............@....@..
....@....................@....
..............................
@@...............@............
..@......................@....
...........@@.............@...
..@....@.....@...@@.......@.@.
..............................
@......@.............@........
...@..............@.@.....@...
...@....@@........@........@.@
.@......@......@...........@..
@................@@...........
