30,30
@@.......@.....@....@...@.....
...........@.....@............
.@...........@................
.............@...............@
..@....@............@...@.@@..
...@..@..@..............@.....
.@.........@...@......@..@@..@
....@.@.......@...........@...
.........@@.............@...@.
.@.....@.@..@........@........
@....@....@...@...............
...................@..........
........@.....................
..@.@........@.........@......
..................@...........
..@..@@.....................@@
...@@........@..@....@........
........@................@....
.....@.......@....@..@........
...............@..............
..........................@...
.............................@
.........................@@...
...@...@.@.................@..
...@...........@...@..@.......
..............@.....@.....@...
......................@.......
..............................
....@......@..................
..@.........@.................
