30,30
................@.@..........@
..@.....@.....................
.@@.......................@...
...........@........@..@@...@.
....@..@..@.........@.........
...........................@..
...@@.......@...........@.....
.@.....@............@@..@.....
@.....@.......................
....@.@........@..............
........@.......@.............
..@..@....@...@...............
.....................@@.......
@....@..@....@.......@..@.....
......@........@..@@..........
@...............@....@........
...........@..................
..............................
........@..@..........@.......
..........@@............@@....
@@...................@........
....@...................@.....
............@............@...@
.@........@...................
....................@@...@..@.
..............................
.....@..........@...@..@......
.....@.........@.....@@...@..@
....@.............@..@........
.............@..............@.
