30,30
...@..........................
............@.@....@..@.......
....@...@.....................
..@.........@@.@....@...@@..@@
.@@.....@.....................
...@..........................
..@.........................@.
........................@@....
................@.@...........
.............@................
...@...................@..@.@.
...........@............@.....
.........................@....
.@.@........@..@.........@....
.........@@.@.................
@.@.............@......@......
....@@..@..@....@....@@.......
.............................@
........@..........@.......@..
........@....@..@..........@.@
......@................@...@..
..@...@....@.@...@.@...@......
.....................@...@....
............@..........@..@...
.....@.......................@
.......@..@.....@............@
@.@...........................
...............@....@.........
...................@..........
@.@...........................
