30,30
..........@........@..........
@..........@......@...........
.@................@........@@.
..............@.............@.
.....@.....@......@...........
..............................
..@.....@.......@@...@....@...
.....@..@.@...................
@......@......@.....@.........
.........@@....@..............
@.............................
....................@.........
..@......@.@...@....@...@.....
...@.......@..................
....................@...@.....
@........@..@.........@.......
.............@..@..........@..
......@...@....@......@.@.....
...@.........@.@....@@.......@
.@..........@...@......@......
....@...................@.....
.................@..........@.
...........@.....@....@@......
..@...........................
..............................
............@......@..@..@@...
...@..........................
.@.....@@..@.....@........@...
................@.............
@...@...@....@................
