30,30
.............@@......@@.......
................@............@
.......................@......
..............................
....@..........@..............
.@....................@.......
....@......@.................@
.......................@......
@...@...............@...@.....
................@@............
......................@.......
...@...@...........@.....@....
.......................@......
............@.....@.......@...
......@......@................
....@....@........@...@.......
.@..............@.@....@.....@
..@......@@@.......@@......@.@
................@.............
................@....@@.@.....
..............@@....@.........
...@............@......@......
..........@......@....@@@.....
.@..@......................@..
.................@............
..........@..............@..@@
......@..@.@@..@...@.@@.......
@.............@....@..........
.@....................@....@..
..................@....@.@....
