30,30
............@............@.@..
........@.......@......@......
.......................@......
.......................@......
..................@...........
.@...............@.@.@........
.........@...........@..@..@.@
........@.....@...........@...
..........@..........@.@.@....
.......@.................@....
.....@...@.....@.......@......
..................@...........
............@..@.@.......@@...
...........@..................
....@....@.........@...@......
.@.............@............@.
.........@..@.@...............
..............@..@...........@
.......................@...@..
....@.........................
@.............@..@.@...@......
.........@....@...........@...
..................@..@........
......@.@.............@.@..@..
..@....@...........@...@......
..........@.........@..@......
....................@..@..@...
@..@...................@......
..@..@........@....@@.........
...................@..@.....@.
