30,30
...........................@..
@......@.................@...@
...@................@.......@@
....@..............@......@...
........@@.............@.....@
..............................
........@.....@.......@..@....
.....@.........@........@....@
........@.@...................
@............@.......@........
......................@....@..
@......................@......
.@.....@.........@..@.........
.....@...@@.............@...@.
...@@..@....@.........@...@...
.@............@...............
@........@...............@....
............@............@....
.......@..@@......@...........
................@.@....@......
....@.............@...@.......
....@....................@....
@...........@.@...............
............@@................
..................@...........
.....@.......@@...@...........
.....@......@...@.............
........@........@.........@@.
...@........@.....@....@....@.
........@.....................
