30,30
....@..........@....@.........
@...@.@@............@@......@.
........@...................@.
@.........@....@..............
......@.....@.................
.......@......................
..@..........@..............@.
.......@..@@.............@....
............@.............@...
..........@....@...........@..
.@..@..@........@@.......@....
.@.........@....@.............
.....@..............@......@..
.....@....@........@..........
........@.....@......@........
........@.........@...........
...@....@@....@...@...........
..........@................@.@
.........@....................
..........................@...
....@............@............
@@................@.........@@
..............@.....@.........
........@........@@...........
..@......@.@..@..@..........@.
..@....@......@..@............
....................@.........
..@.@...............@.........
......................@.@..@..
.................@............
