30,30
....@..........@..@....@.....@
.....@..@......@....@.........
...@.........@......@.........
......@@@...@...@.....@.......
..............@......@....@...
...@.........@...@..........@@
.....@.....@...............@..
@...@.........................
...@@......@...@...@..........
...........................@.@
........@...@.@.........@.@...
............@...........@.....
.@............................
......@...@@......@..@........
@.................@...........
................@.............
..@..........@.....@..........
.....................@........
.@..............@....@.......@
........@......@..............
..........@@...@.............@
..............@.........@.....
@..........@..............@...
..........@............@@..@..
........................@...@.
.@..@.........................
......................@.......
..............................
.....................@.@......
...@...............@.@..@@@...
