30,30
.@............@.......@.......
.........@@.@.................
..........@...................
@............@...........@@..@
@..@.........@..@.............
....@.........@...........@...
..@@..@.........@@.....@@.....
.......@.........@.@...@......
....@....@....................
.....................@........
....@@.......................@
...............@.....@......@.
.....................@........
..@..@.......@................
........................@.....
.....@..........@..........@.@
.@@................@....@.....
...@........................@.
....@.........................
.......@...................@..
.@.....................@.@.@..
...@..........................
.@.......@......@.....@.@@@.@.
.........@.@..................
..............................
........................@..@..
.@..........@..............@.@
@.....@.........@....@........
.@.......@....................
....@.@......@...@........@.@.
