30,30
..............................
................@@..........@.
..@.....@...........@....@...@
.@.........@.@@...............
.....@...........@........@...
...........@......@.......@...
............@...............@.
@@...@......................@.
....@.....@.@..@...@........@.
.........@@@.......@.....@....
............@..@.........@....
@................@............
..............................
...@...............@......@...
.....................@...@....
..........@......@..........@.
........@.....................
......@................@......
....@.....@@...........@@.....
........................@.....
@.@.........@.@...@..@@.@....@
...@...................@......
.@.....................@......
..............@.@.............
............@.................
...........@................@.
...@................@.....@...
@..@.....@.@@.......@...@.....
.............@....@@..........
@.@...........................
