30,30
............@@................
...@......@@.........@..@.....
.....@.......@..........@.....
..................@@..........
...........@.................@
................@.........@@..
...............@..............
@.....@.@.....@......@........
.........@...............@....
.....@....@........@..........
........................@.....
.......................@......
.....@...@.........@..@.......
..........@.........@@.@....@.
....@...@....@................
........@.....................
.....@.....@..................
...........@.......@..........
..@....@..@..@...@@........@..
@...........@......@@.........
.....@........................
............@.......@.........
.........@........@....@....@.
..............@....@...@......
..........@@....@...@.....@..@
...............@.............@
..............@....@..@.......
.............@........@.......
......@...........@...@....@..
.....@..............@.@@...@..
