30,30
@...@....@..........@.........
..................@.....@.....
.@....@.......................
..........@..@.........@......
...@..........................
@.....@.....@....@..@..@......
......@@..............@.....@.
......@.................@.....
......@...@@@.................
..........@...................
.@@......@.......@............
...@....@..@.....@............
.....@.......@@..@..@....@....
.................@..@.........
...@.....@.@..........@.......
.@............................
@...................@.........
.........@................@...
...@.......@..@....@@...@.....
.......................@......
........................@.....
@.....@............@.@........
.....@........@.....@.........
............@...............@.
.....@........@..........@...@
..@.....@................@...@
...@..................@...@...
@..................@.......@..
.....@...................@....
...@....@.............@.......
