30,30
.......................@......
....@@...............@.....@..
.@............................
.......@.........@...@........
@.............@....@..........
..............................
.................@............
.....@.....@...@......@@@@....
..............@.........@.....
..........@...................
.........@.....@.......@......
..............@...........@...
......................@...@...
..@............@...@....@..@..
....@................@........
............@.................
...@.@...........@..@....@.@.@
...............@..........@...
@..............@.........@....
......@..........@..........@@
.@@......@.....@...........@..
.........@@..............@....
....................@..@....@.
.........@.@..............@..@
@..@....@@@....@....@........@
..............................
@@.......@............@.......
..@..............@@...........
......@..@....................
.....@..@.........@....@......
