30,30
....@...............@.........
.....@...@.@.......@....@.....
......@@.@.......@....@..@@...
.@....@.......................
..@.......@....@@.....@.......
.@......@...@..@..............
.....@..@.............@.@.....
..@....................@......
......@..@....................
.......@@................@....
...@......@...................
..............................
.......@......................
.....@...............@........
...........................@..
.....@.....@................@.
.@...................@@.......
..........@...................
......@...@@.......@@....@....
.............@@...............
...@...................@......
.................@.....@...@..
........@....@........@.......
..............................
..@.................@..@......
@..@.........@@........@...@..
....@....@....@@...@.@........
.@......@............@........
.............@....@.....@.....
...@...@..........@.....@.....
