30,30
....@.....@..@.@..............
...........@.@.............@..
..@.......@.....@..@..........
..............................
..@........................@..
...@.................@.....@..
....@......@.@...............@
.................@.......@..@.
...........@.........@@.......
................@.@..@....@...
..............@...........@...
....@.........................
@.....@...@...................
............@.......@....@....
@.................@..........@
......@.....................@.
...@@..@.....@.@....@.........
...............@.@@..........@
..........@...................
.@.@...............@..........
...@....@....@.......@........
....@.......@.....@.@.........
........@........@......@@....
..............................
......@@......................
..............@@....@.........
.@...@.......................@
...@....@..@..@......@.@......
........@........@@...........
......@...............@...@...
