30,30
....@......@.@...@.....@......
.......@.......@..............
.....@..@...........@.........
....@...................@...@.
..............................
........................@@...@
.@..................@........@
..@@....@..@..............@...
............@................@
........@...@..@..............
..@..@..@...@.....@.@........@
........@.@....@..............
.@...@.................@...@..
.........................@....
..............................
..............@.@.@.......@...
...............@.@......@.@.@.
..............@@..............
.....@..@.....@.........@.....
.........@...@............@...
.@..@..@@@..@.................
.............@..............@.
@@..@.........................
......@@.@......@....@......@.
.@...@......................@.
.........@.......@......@@....
..@...........................
..............................
.............@..............@.
.................@............
