30,30
@@......................@.....
..........@........@..........
..........@..@@..@............
.....@@.......................
.@.......@.........@..........
...@.................@........
......@......................@
..@.@.......@.................
.....@.@........@......@....@.
.......@.@.....@@.......@.....
...................@..........
..............@.............@.
..............@...@...........
.@...........@................
.@..........@...@.......@....@
.@....................@.......
...@...........@.......@....@.
......@.....@.........@.......
.................@.....@......
@...........@..@@@............
..@..............@.@@...@.....
...@....@.......@.............
.......................@....@@
........@@...@..@...........@.
.................@....@.......
.........@......@...........@.
.................@....@......@
....@.@.....@.................
@.............................
...........@...............@@.
