30,30
.@..@...........@.............
.......@........@.............
@.........@...................
......@.......................
.....@....@....@....@.........
....@........@.....@...@......
.............@................
.@.....@..@.........@....@....
..@....@..............@@......
@...............@.............
..@.........................@.
..............................
...@..........................
....@.........@...........@..@
...@..@.......@........@......
.....@...........@...@.....@@.
........@.@........@.@.@...@..
.............@........@.......
..............................
.@................@.....@..@@@
....@...@@....@...............
...@.......@........@......@..
............@......@..@.......
@@........@.@.................
..............................
.@...............@..........@.
........@......@.....@@.......
.............@....@......@@...
...@.............@..........@.
......@....@......@...........
