30,30
...........@.............@@...
......@...........@....@...@..
.......@.......@......@.@.....
...............@..............
.@...@....@.....@.......@.....
..@........@..............@..@
.@..........................@.
@..........@...@....@...@.....
........@...........@.........
..............................
@.@.....@@@.@....@.......@....
.@...............@..@..@.....@
..............................
........@@.....@..............
.@@................@..........
..@.....@@....@.............@.
...............@.@...@........
@.............................
.......@........@@............
...............@..............
..........@..................@
............@.................
@.....@...........@...........
..............................
.@.....@...@....@.....@.@.....
......................@...@...
@.@........@..@.....@.........
............@...@...@...@.....
...............@............@.
..............@...@.........@.
