30,30
..................@..@.@......
..@.................@.........
..@..@..@....@..............@.
.........................@.@..
......@.......@..@....@.......
....@......................@..
..@.........@..@........@...@.
...........................@..
.......@.....@.@@.....@....@.@
...............@.@.........@.@
............@@.@..@....@....@.
.....@........................
..............................
........@........@............
..............................
.........@...@.............@..
.................@@...........
...@......@..........@........
.......@.........@.@..........
.............................@
..@.....@.....................
@..@.......@.........@@.......
....@..@.............@@...@...
.@..@@..@..@...@...........@..
......@...............@....@@.
.............@..............@.
...........@.@................
.............@................
.@@@............@.......@.....
.............@................
