30,30
...@............@.............
................@.............
.@@...........................
....@....................@....
@....@..@.@.......@......@....
..............................
......@...........@.@.........
....@......@.......@..........
...................@.......@..
....@............@............
@....@.........@.....@....@...
....................@.@.@@...@
.............@@..........@....
...@..........@..@............
..........................@...
..@....@...........@..........
......@.......................
.@........@.................@.
.......@..@....@.........@@...
.....@......@.................
..........@......@.........@..
................@...@.@.......
..@..@..@.@....@@...@.@.......
.......................@@.....
....@.................@.......
...@......@.......@....@.....@
....@.@....@@....@............
......@........@.......@...@..
.....................@........
....@...@.................@...
