30,30
@....@.@............@.........
.....@..............@....@.@..
........@.....................
.......@....@.................
................@.............
..............@..@......@.....
...........@.@............@...
@...........@.................
@.................@....@......
..@..............@.@...@....@.
....................@.....@@..
..@.@...@......@..............
.........@...@........@.......
..................@.....@.....
....@@..@..................@..
.............@.@@.@...........
.@.....@..................@.@.
.@...............@........@...
..........@.................@@
...............@..............
..@@........@..............@.@
......@@........@.@...........
..............................
.....@..@.....................
..........................@...
......@@@..@..................
...@..............@....@......
.....@............@....@......
..@@..........@.....@@....@...
.........@...............@...@
