30,30
.............@.....@.@.....@.@
.......@....@@................
............@.................
..........@.@........@..@.....
....@.@..........@......@...@.
......@@......@...@......@....
.@..........@.@...@.@.........
..........@@.............@....
....@@...@.@.............@....
...@..@....@...@..............
..............................
....@..................@.@....
..............................
................@.@...........
..................@...@..@...@
......@.....@............@@...
................@@@.@........@
.....@......@.................
....@@.....................@..
...............@........@.....
...@.......@...@..............
..............................
.@..@..@......@...............
...@...@.@...@.............@..
...@.............@............
...........................@.@
...@......@...................
.........@............@....@..
......@.........@.......@....@
..............................
