30,30
.............@@...............
..............................
...........@.@@...............
.....@......@...........@.....
...@.@..@........@@.........@.
...@..........................
........@.....................
...@....................@....@
.......@..@.....@.@...........
.......................@@.....
..............................
@.@.....@...............@@....
...........@.........@.......@
@............@..........@.....
.@.@....@..............@...@..
..@.@.@.........@@............
..............................
........................@.....
....@......@......@...........
.........@..@@................
......@@.@............@....@..
@........@@.@..@@@......@..@@.
.......@......................
@@........@..........@........
.............@....@...........
....@.......@.................
...............@.@..@.@.......
..........@................@..
............@...@@.....@......
@......@@.....................
