30,30
...............@....@.........
.@.@................@....@....
..........@......@............
.............@...........@....
.@@...@@......................
....@..@.......@...@.........@
.....@..@...@..@...@..........
.............@................
.@...............@.....@...@..
@..........@....@....@@.......
.@....@....@..................
.........@......@.............
.@.......@....................
...@..@.@.........@...@.......
......@..@.....@.........@....
@.........@...@...............
..............................
......@.......................
.@.......@................@...
.......@..........@...........
....@.........................
.........@@..@...@.......@...@
.....@..............@.........
...@.........@................
..........@..........@.@...@..
.....@.@..........@...........
.......@@...@...........@.....
....@...@...@.@......@........
......................@.......
...@........@......@..........
