30,30
..................@.........@.
...@....@@@.@.....@@......@...
......@.@..........@.@.@@.@.@.
.......................@@@....
....@.@@.......@........@.....
.......@@...@......@..........
.@....@...........@........@..
........@...........@...@.....
....@...@....@................
..............................
......@..@..........@.........
@....@........................
....@.........................
.........@.....@.@......@.....
......@................@.....@
.....@...@............@.......
..............................
.............@...@............
........@.....................
..@...........................
..@....@.....@........@.......
..@..........@..........@.....
............@..........@..@...
.........@...................@
..@....@......................
.@.............@..............
.............@.@.@...........@
.............@....@..........@
...@@...@...@............@....
.@..................@.........
