30,30
@...@........@..............@.
....@...........@.............
............@...@.............
..@.@@..........@...........@@
@.......................@@....
............@@..........@@....
...........@.............@....
@......@@.........@@.@@.......
..........@..@....@@..@......@
@.....@.......................
...@...............@.....@....
.......@......@...............
.......@..@@..@..........@....
..............................
.....@......................@.
.....@..........@.......@.....
......@....@....@......@..@...
..@.@.@...............@.@.....
.@..........@.@...............
......@...............@....@@.
..............................
.@........@..@..@...@@........
..............................
....@...............@.........
..................@.@.........
.......@......................
........@......@........@.@...
.........@....................
................@.............
...............@....@..@......
