30,30
..............................
.@....................@..@....
....@.....@............@....@.
.......@..@..............@.@.@
......@...........@...........
@...@.......@.@........@......
...@@.....@.....@@..@.........
...........................@@.
....@............@@..@...@....
................@.@...........
@.............@...............
.....@..@.@...@...............
.............@...........@....
@..@....................@...@@
.............@.........@......
...................@..@@....@.
..@..........@......@.........
.............@................
....@@.......@...........@....
................@.............
......@....................@..
..@....@...............@....@.
......@...@..........@........
...................@....@..@..
...........@..@@..............
...................@..........
@........@........@...........
...................@..........
...@.@....@.........@......@@.
...............@............@.
