30,30
..@.......@.....@.......@.....
....@............@.@..........
.@...@....@........@...@......
........@.................@...
...@...@....@.................
...@...@.................@....
..@........................@..
......@.....@.......@.........
..@..@...@....................
...............@.......@..@...
@....@.@..........@...........
.............@.......@..@.....
....@.......................@@
.@.......@.........@@.........
..@@@.@@............@.......@@
..........@.......@.....@.@...
@.................@.@@........
....@.................@.......
@...................@.........
...@.........@......@.........
.............@.............@..
............@....@............
......................@.......
......................@..@....
.............@...@............
....@.........................
..@...@....@.@................
..................@........@..
......................@.@...@.
...@.....................@..@.
