30,30
...@....................@.....
................@.............
....@....@.......@...........@
....@.........................
...........@................@.
.@......@.@..@..............@.
........@............@...@....
....@..@....@.......@...@.....
.@@..........@....@...@.......
............................@.
.......................@...@.@
.....................@.....@..
...............@....@..@.@....
..@...@..........@............
@..@....@.@..@.....@..@.......
.......@...............@...@..
...@..@.......................
...........@..@...............
........@............@.......@
..@..............@..@.........
@............................@
.....@................@......@
..............................
.@............@..........@....
....@.....@@..........@.......
@.@.......@@.@.......@........
@...........@.........@.......
@.............................
...........@.@........@.......
............@@......@......@..
