30,30
.........@.......@@..@...@@...
....@.@@...@..................
.....@@..............@........
..@....@..................@...
............@........@.@......
......@...@....@.@...........@
.@@....@.................@@..@
.........................@...@
..............................
.@.@.................@..@.....
..@........................@..
.....@.@......................
..@......@.@.@................
...................@.........@
......................@.......
........@...@.................
..........................@...
@.....................@.......
.........@.........@..........
..@......@....@....@........@.
..................@...........
........@........@.....@......
....@@...@.......@....@.......
...@..........................
......@@.......@..............
.........@........@.....@.....
.........@..........@.........
....@@..@........@.....@@@@...
............@...............@.
................@.....@...@...
