30,30
..@.@@...@.@...........@..@@..
@.......@..@.@.@@@.@@.........
............@.....@....@......
@..............@..............
..........@...........@.......
@......@@...........@@........
...............@..............
.........@.....@..............
..@...@.......@...............
.....@......@@...........@....
.....@..@@....................
..............................
...........@..@.@.............
........@.............@.......
......@.......................
..@@.....@.........@..........
......................@.......
...............@..............
..@.......@...@.......@.......
.........@................@...
.....@.@......@..@.......@....
.............@................
............@.......@.........
................@...@.@.....@.
...@.........@......@.......@.
.....@...................@....
......@...............@.......
.....@.....@..............@...
..........@..@.@..............
.........@....@.........@...@.
