30,30
........@.............@...@.@.
..................@@..........
...@..............@.......@..@
..........@@......@@..@.......
......@...@...........@.......
.............@................
....@...............@@..@.@...
.........@.@..................
....@...@...@.....@@......@...
.@....@.........@.............
...................@....@.....
@..........@......@.......@...
.......@@.........@@....@.....
..............................
.....@..............@.........
.@..@.....@................@..
................@.............
.........@.................@..
..............................
.......@.....@...........@.@..
.........................@....
..................@...........
.......@.....@.....@....@..@..
...........@..................
.....@.......@.@.@............
.......@......................
..................@..@........
.....@....@.@@@..........@....
................@@.@.@........
.@......@.......@@..@..@......
