30,30
..@@.........@...............@
............@.....@.....@.....
.............................@
.@.................@....@.....
@.............................
..............................
@@......@....@.@...@.........@
..@.........@........@........
@.@..........@................
..@...@..@......@......@......
.@.@.@.....................@..
.........................@...@
......@.....@......@.@.@...@..
...@..........@.......@.@.....
..............................
......@.@.....................
...................@@@......@@
....................@.........
......@........@..........@...
............@..........@......
..@......@@..@...@............
............................@.
@..@.......@.@.............@..
...........@...@@.............
.............@@..............@
@..........@.........@.@......
......................@.......
..@............@.@........@@..
..........@......@.....@......
.......................@......
