30,30
.@....@.......@...............
......@......@.........@......
.....@.................@....@.
....@@........................
.......@.......@.@............
.........@.@.@................
.....@.....................@.@
........@..@@.......@.........
...................@..........
..@...@.@@.@.......@..........
.......@......................
................@.......@.....
..................@...@....@..
....................@.........
@.......@.........@...@.......
................@.....@.....@@
..@.@....@@...........@.@@...@
....@...................@.....
@......................@......
.........................@....
..........@.......@...........
..................@...@@......
...@.....@..@...@......@......
..@@....@..................@..
....@.....@..............@....
.@........................@...
..................@.@....@....
......@@...........@..........
@..@@....................@.@..
........................@.....
