30,30
.@.......@@..................@
.............@...@...@.@......
..............................
..........@..................@
....@..@......@.......@@......
.@............................
..........@.........@@.....@..
...@..........................
........@.....................
...........@..............@@..
.@.@@...@...@.......@......@..
........@.........@.@...@..@..
.....@.@.........@............
@...@..........@..............
...@.........@.......@........
.............................@
.............@@...............
...@..@.......................
@...@......@..................
.....@............@...........
...@....@@........@..@........
.@....................@.@.@...
..@.......@.@.......@.........
......@...@...................
@.............................
.............@...@....@.......
....@.....@..@.@@.............
.............@..@@.....@......
.....@..@..........@........@.
......@.@.....................
