30,30
@.................@.....@@..@.
..@...........................
.@..............@.............
......@...............@.......
..@........@...@....@.........
....@...................@.....
........@.............@.......
...................@......@...
........@.....................
..............@...........@...
.@..@.................@..@....
.....@.@.......@...@..@.......
......@...................@...
..@..........................@
..@.....@.....@...............
.@..........@@..............@.
................@.............
@.................@......@...@
.......@.....@@...........@.@.
....@........@........@@......
@........@........@...@.......
........@.....................
@.......@..........@..........
.@................@.........@.
.@......@......@..@...........
...@@......@..............@.@.
@.............@......@@.......
..........@..........@........
.........@.@.....@....@.......
......@.....@.......@.........
