30,30
.............@.....@.....@.@..
.........@...@@.@..........@@.
@.............................
.@.@..@.......................
.......@....................@.
...@..........@.......@...@...
..@..@..@.....@..@............
.....@..@.....................
.....@..@....@..@.............
..........@...........@.......
..........@........@.@........
......@................@......
.................@.@..........
..........@.@....@@...........
.......@.........@............
.........@.@....@.....@....@..
.@......@@.@..............@...
@..........@.......@.......@..
..............................
...........@....@.......@.....
....@.........................
..........@......@.@..........
.....@......@......@..........
..@.................@@..@.....
........@@....................
............@............@...@
.@.....@@..@.......@..........
.........@...@.............@..
..........@...................
@..........@..................
