30,30
..@.........@.....@..@........
...@@.@.....@.........@......@
........@......@....@.........
...............@..............
............@....@....@..@...@
.........@....................
.....@@.@.@.................@.
........@.................@@..
@.@........................@..
......@...@...................
....@.....@....@..............
................@........@....
..............................
.......................@...@..
.............@.....@..@...@...
................@....@........
........@...@@....@...........
...@..@...@..........@......@.
.@.....@.....@........@...@.@.
.@....@.............@...@.....
...@.@.......@...........@....
.....@........................
...................@.@.....@..
..............................
....@.....................@...
..@@..........@@..@...........
.@@...........................
..@..................@........
.@..................@.........
............@@.........@...@..
