30,30
....@.@..........@...@..@.....
..@..........@@...............
.@...@......................@.
@........@...........@........
........@.......@.......@.@...
@..@@......................@..
................@.............
...@..@....@..................
...............@..............
.............@.........@.....@
...............@@......@..@...
...........@..................
....@.@......@..........@.....
.......................@.@....
.........@............@..@....
.....@.@@................@@...
.......@.....@.@.@............
.........@..@...@.@...........
....@......@..................
...@..........@...@......@....
.....@............@...........
............@.............@@.@
..........@......@............
.......@.@...@.........@.@....
..........................@...
.@..@............@............
@.............@.........@.....
.@...............@............
.....@.....................@..
...............@.@......@.....
