30,30
..............@@.....@......@@
..............................
....@........................@
......@.............@.......@.
...@..@......@.............@..
@...........@@......@.@.......
...........@............@....@
...........@....@......@.@....
............................@.
@@....................@.......
....@....@..............@.@@..
............@...............@.
......@.........@..........@..
.....@...........@............
...........@@.................
.......@...........@..........
.@...@............@....@......
...........@.....@....@......@
..@.................@@....@...
........@......@..............
........@.....................
............@.......@.........
.............@...........@....
.......@................@....@
...@..@.@..........@@....@.@..
......@.......@............@..
@..@......@.......@@.@........
........@.....................
...................@...@......
...........@........@......@..
