30,30
.@....................@.@@....
.........@...........@........
......@.@...........@......@.@
..@...........@...@...........
...@...........@....@.........
....@.........................
............@......@....@..@@.
...................@....@.....
....................@...@.@..@
......@......@.@....@.@.....@.
..............................
.....@............@...........
...@..@......@..@.............
.@..@...........@@...@...@....
..............................
......@...........@...........
@...@...@.........@@.@..@.....
..........@...........@....@..
..........@...........@..@....
.................@............
..@...........................
..............@......@........
@.....@.....@......@..@@.....@
....@.............@.....@.....
..........................@...
.@...@.......@.......@........
.........@.......@........@..@
.....@..............@.........
@.............@...............
...........@..................
