30,30
..........@@.....@.......@@...
@.........@@....@..@.....@...@
...............@.@............
............................@.
.......................@......
.........@....................
..............@....@.@...@@.@.
..............................
..@...@....@..................
...@..........................
...@.@..@....@.@.......@......
..@@.....@....................
......@..@.@..................
.............@..@............@
.@.......@......@.............
.....@............@...........
......@.@...@......@.......@..
............@.................
.........@...........@........
.@.@@..@....@.................
.....@.........@..@..@........
@.......@.....................
.....@..............@.......@.
...................@..........
..@......................@.@..
......@@....@.@....@..........
.@.............@...@..........
......@@......................
.@..........@..@..@...@.......
..............@.............@.
