30,30
..@@@...@...@.@...............
..........................@...
.........................@@...
.....@.@................@.....
............@......@.@.....@..
......@......@...@...@........
........@.....................
....@....@.....@.@...@........
.@............@...............
..............@....@..........
.@................@@..@@....@.
@......@@..@..........@.......
..@.............@@..@.........
.@............@...............
......................@.......
......................@.......
....@.....................@...
.@.@............@@............
.........@@........@.@........
.@.@...............@........@.
..............................
.......@.............@......@.
.............@................
.@...@....@................@..
...@.................@.....@..
................@.....@@.....@
..@..@....................@...
.......@.........@............
....@......@..@........@...@..
............@.............@...
