30,30
.@................@...........
.@@..........................@
..@..............@............
.@.............@@@............
..............@.@.............
............................@.
.....@..@.....................
..........@.@.................
..@.........@.@.....@.........
@.@...........................
@.............@.............@.
.............@................
..@@..........................
.............@.....@..........
.....@.........@....@.......@.
.......@.............@...@....
........@...@.................
..........@@.................@
...@.@.............@..........
............@..@.@........@...
......@.........@....@........
.@......................@.@...
@.........................@...
....@..@.@.@@@...@..@.........
@.@..................@........
@...@.....@........@.........@
@..@.....@@.........@.........
....@@.......................@
.....@.@....@.....@...........
..............@....@.........@
