30,30
@...@.@.@.................@...
...@.......@........@.......@.
...........@...........@.@..@.
......................@.......
....@.............@.@.@.......
.@...............@..........@.
.@.....@.@..........@..@......
..............................
.......@..........@.....@.....
.........@....................
...@...@.........@.@...@......
..............................
....................@@........
.....@........@....@........@.
..................@...........
.............@.....@@........@
............@.................
.......@......................
....................@.......@@
.........@........@....@......
................@@@....@....@.
..........@@......@...........
..@@@...................@.....
@.........@.....@...........@.
@.........@.............@@...@
...@.......@@.@@..............
.@...............@............
...........@@..............@..
.......@....@......@..........
..@.................@.........
