30,30
.....@........................
..@...............@........@..
.@...@.....@.@...@............
..@.@.........................
...............@.........@...@
....@....@....................
.@..........@..@...@..@.......
............................@.
@.........@...............@...
....@..@....@.....@.......@@..
...........@..........@.......
..@.@@.......@..........@....@
..@.....................@.....
.....@.........@..........@...
.....@..............@....@..@.
..............................
....@.............@.....@.....
.................@............
..........@..........@.......@
...............@............@.
...........@...........@......
......@.......@...............
@.............@..@...........@
....@.....@...................
....@..@................@.....
..@........@..................
..@.............@.....@....@@.
@....@...........@............
@...@........@.............@..
....@..@@@..................@@
