30,30
..............................
...@...@@..............@@.....
..@...........................
..@........@.................@
...........@..@.....@........@
.............@...@..........@.
.......@@.........@...........
....@@..@......@..@...........
.......@..@........@..........
.....@...........@....@......@
..............@...............
.@.......@..@......@.......@..
.............@......@........@
.@.....@....................@.
....@.......@..@..........@...
........@...@.....@......@....
@....@..............@........@
@.@...........................
............................@.
@.........................@...
............................@.
.....................@........
......@................@......
@....@........@...@..@.....@..
......@......@...........@....
@.............................
.........@......@.............
...............@..........@...
...@.@..@.@@......@....@......
.....@.......@........@..@..@.
