30,30
..............................
.@....@..@................@...
..@..........................@
..............................
@.....@...@...................
.......@.@........@...........
......@.......@...@...........
..@.......@...................
.@....@..@.@.@......@.........
...@..@...........@@@.........
........@.@.....@....@........
..@...........................
..@..............@............
.........@.@..........@...@...
...............@..@........@..
..........@@......@.@.........
....................@.........
..........@.@.................
......@......@.@..............
.@..........@@......@.........
...................@.....@....
...........@............@.....
@@................@...@@.@....
@@.........@...@.....@.@......
..............................
@..@......@....@.......@......
.@.........@.................@
..........................@...
.@...........@........@.......
.....@@..................@.@@@
