30,30
....@...@..@...........@....@.
........................@@....
..............@...............
.@..............@.............
...........@....@..........@..
.............@....@........@..
..........@....@...@.......@..
.....@..............@.........
....................@...@....@
.....@@@......................
..@....@..............@@.@@...
@.@.................@...@.....
..................@....@@.@...
..@.....@.............@.......
.........@@...................
....................@.......@.
..................@.......@...
.......@......@.....@@........
....@.......@.................
...................@..........
.............@.........@.....@
.@........@.................@.
...@@...@.....................
....@..@...@.........@........
.......@.......@......@.......
@.....@..................@....
...@......@...@..@...@.....@..
..............................
.......@@.....................
@...@...........@.@......@....
