30,30
......@@..................@...
......@..........@.@........@.
........@..................@.@
.................@............
..............@.........@.....
.....@.....@.@@....@@..@......
...@.......................@.@
@...............@.....@.......
@..........@.............@....
.........@...........@...@.@@.
............@.................
...................@..........
......................@.......
.....@...@............@@......
...................@.@........
@..................@........@.
................@.......@.....
..............................
....@.@....@@@................
.................@..........@.
..@...@.................@@..@.
............@........@@.......
.....................@@.......
..@....@.@@@.....@@..@........
................@.............
......@.......................
....@@....@.....@.@...@.......
@.@................@..........
..@@....................@.....
...........@@.........@.......
