30,30
..............................
........@...@................@
....@.....................@...
..@...................@@@.....
..............@...............
..............................
.@................@.......@...
.@..@..@......................
.................@..@@........
@..........@.....@@.........@.
......@............@@.........
........@...............@.....
........@...@@@...............
...@.....@....................
.............................@
...@..@.....@.......@.........
.@@..@..@@.....@..............
........@....@...@..........@.
...@@...@.......@.......@.....
.............@..@.............
@.....@.....@...@.@....@...@.@
...@........@.............@...
.....@......@............@....
............................@.
..@...@..............@.......@
..............................
.@.....@......................
...@..........@.....@.........
..@@..........@...@@........@.
.....@......@@................
