30,30
....@......@..........@.@...@.
........................@.....
..@.........@.................
..@........@.@@..@.....@..@...
......@..........@.........@..
......@.....@......@..........
..............@...@...........
.........@..@...........@.....
...........................@..
......@....@..........@@@.@@..
..............................
..@.@......@.@.@.......@......
....@...@......@............@.
......@....@...........@......
....@........@.....@..........
..........@...................
..................@...........
........@.......@.......@.....
...........@...@..............
......................@@......
.............@....@..@@.......
.................@............
.@..................@...@.@@..
.....@....@........@..........
..@@.............@@...........
..@......@....@...@.@....@....
.@@.....@@..@.@...............
..............................
............@.................
............................@.
