30,30
....@...@...@@................
.....@............@...........
....@.......................@.
.....@...@@..@.@..............
...@..........................
..............................
.......@.....@.@.@..@.........
.@@...........@............@..
...@.....@......@.............
...@..@..@.@.......@........@.
.......@@@....................
..@........@................@.
.............@....@...@....@..
...@..........................
....@....@...........@......@.
...@.........@........@.......
........@......@..............
..............................
.@..@.......................@.
...@..........................
..@...@..........@.......@....
..........@.......@....@..@...
@........@.........@..........
..............................
..@.....@.................@...
..@........@......@...........
.@...@.@.........@.........@..
..@...@...............@.......
.........@...@.........@...@..
................@..@.@...@...@
