30,30
..............@..........@....
.......@....@.@.........@.....
......@......@................
...@.@@.@.@............@..@...
...............@..............
......@..........@............
............................@.
...@.............@..........@.
.......................@@....@
@@.........@................@.
..@.........@.................
...@.@.......@........@.......
........@...................@.
..........@..................@
..@................@..@.......
...............@...@.........@
........@........@............
....@........@..............@.
.@@......@............@.......
...@...@..............@.....@.
.@..........@@..........@.....
.............................@
....@.....@.........@.........
....................@.........
..............................
.@.............@..@...........
.@....@...........@.......@@..
...@......@.........@.........
.@.......@.............@....@.
@..@.......@..@.@..@.@.....@..
