30,30
....@......@...........@@..@..
...........@@.............@...
.............@................
.....@.................@......
..........@.........@@........
..@..@..............@.........
.@...@..@.....................
....@..................@......
..............................
..@...........@..........@....
..............@..........@....
.@...@..@..@....@.....@.......
............@........@...@....
.@......@............@........
..@..........@......@@.@@.....
..@.....@..@.......@..........
...................@..........
.@.....@......@...........@...
@..@.....@..............@....@
@...@..@............@.@...@...
.......................@..@.@@
..........@...................
@......@...................@..
.......@......................
@.......@....@.....@......@...
.........................@....
@..@..........................
.................@............
......@....@............@.@...
@......@....@.................
