30,30
.@...........@......@@......@.
............@.......@.........
........@.....@...............
...........@................@.
...@......@...............@...
.....@.@.............@........
...............@.......@......
..........@.....@.......@@....
.@....@...@.....@.....@......@
.....@.....@..........@...@.@.
.@........@...............@...
..................@.....@.@.@.
.@............................
..@...@..........@...........@
.@...@..@.@...@...............
......@..................@....
......@.@.........@......@@.@.
..............@...............
.@@...........................
.............@.......@........
..................@...........
...@.@...@.........@.@.@......
.............@.......@........
...@@....@....................
....@....................@....
..@.@@........@.@.............
....................@.@....@..
@...........................@.
..............................
......................@..@....
