30,30
.......@.............@...@....
...@.@.......@........@.......
........@............@........
.@...........@.............@..
........@......@..............
....................@...@.@...
..............................
........................@...@.
.......@..........@.......@..@
@.........@...................
@....@........@...........@...
......@.@.....................
............@...@....@...@....
......@@...........@..........
.....@...@....................
............@.................
..............@.......@..@..@.
....@....@@........@.@.....@..
@.....@...............@..@..@.
.....@@.......@@...........@..
.....................@........
@.............................
.....@@@..........@...@.....@@
@......@@@...................@
......@.......................
@.........@...................
....@@.................@......
..@...@...........@...........
..@....@.............@........
.............@@.......@.......
