30,30
.........@...................@
..@...............@...........
@......@..................@@.@
..................@.....@.....
........@.......@.............
........@..........@..........
@...........@......@..@.......
.....@........................
...@..@....@@..@......@....@..
.@...@...@......@.............
.......@..@...........@.@.....
....@@....@.@......@..........
....@......@...............@..
.......@.............@........
...............@...@.@........
..@..@..@........@............
.......@....................@.
@..@.....@@..@..............@.
..............@.@............@
................@.......@.....
..@............@..@.........@@
......@...............@.......
...............@........@.....
.............@......@.....@.@.
...@..................@.......
..............................
..@........................@..
.........@....................
.....@...........@..@......@..
.@.@........@.................
