30,30
...........................@..
............@.....@...........
.@....@..........@............
......@...........@........@@.
......................@.....@.
.@...@...@..@@................
..............................
...................@........@.
..............................
...@..@..@.@.................@
............@.................
.@.@...@.......@.@.@@.........
..@...@........@....@.........
.@....@............@.....@....
.......@......................
....@..@..@...................
..@@....@.......@....@....@...
..............@...@..@........
.@..........@.....@........@..
...........@..@..@@...@.@.....
............@.....@..........@
........@.......@.............
@..@..@......@................
..........@.@....@.........@@.
.....@..............@.........
..............................
.................@.......@....
.................@............
..........@........@.@...@.@.@
...............@......@.......
