30,30
...@..........................
.............@...........@@...
.......@......................
........................@.....
....@.............@...........
..........@@..................
.......@.@...........@........
.................@............
@.........@...................
..@...@..................@@...
@...................@@@.......
.@........@........@.@........
....@.......@.........@...@...
.....@........@.............@.
...@..........@...@...........
@.@...........@.............@.
..................@@..........
..@......................@....
......@.......@..............@
@....@..@..........@..........
...@......@....@........@@@...
@.@.@.........@...............
......@..@.@...........@...@.@
..@..@...............@.....@@@
....@.........................
..............@...............
.....@.@.........@@......@..@.
...........................@..
.@.@@.............@........@..
.............@................
