30,30
..............................
....@.........................
.@.@.@.@..............@.......
.....@............@.......@...
.....@........................
@@.......@@.....@..........@..
...@.@....................@...
.@....................@.......
.....................@.@......
.@@.....@.....................
....@.........................
....@.......@..............@..
........@....@...@..........@.
..@..........@........@..@@...
........@.@..@..@.............
..............................
......@...@...................
@.....@.......................
@.......@.........@....@..@@..
...........@..@.....@.@...@...
...@...@@................@..@.
..@...........................
...........@....@.........@...
...............@...@....@@....
@...............@.......@.....
..........@...@..........@@...
......@........@@@.......@....
...@..........................
..........@..........@...@....
..@......@.....@..............
