30,30
..@.@@.........@.........@.@..
@.@......................@..@.
.......@.......@@.............
....................@......@..
............@..@.......@......
..........@...............@...
......@.........@....@......@.
...@........@.................
.........@@...................
..@..........@................
..@..@@..@@...@..........@....
..............@.....@.........
....................@......@@.
...@..........................
......@@........@.............
...........@..................
.........@....................
....@........@...............@
.@..@.........@...@.........@.
.@............@...............
......@@...@@@................
......................@.@..@..
..............@....@........@.
...........@.......@..........
................@...@.@.......
@.............................
@.............@..@@@..........
.......@...@@............@.@..
......@..................@@...
.@...........................@
