30,30
.............@................
.......@.................@....
.....@.......@.....@.....@....
......@................@...@.@
..........@..@.....@..@.......
...............@..............
..............@..@.......@....
........@................@....
.....................@....@...
.............@@.............@.
......@.............@.........
..................@...........
......@@.@.........@.......@.@
......@........@..............
...@..@.....@.@...........@..@
....@@..............@.........
....@@........................
.............@......@.........
@.......@.....................
....@....@.................@..
....................@.@@@.....
....@......@.............@....
....@....@.@......@...........
...........................@..
.......@...@.........@........
.@......@.......@......@..@...
...........@@.@......@....@@.@
....@...............@.........
......@.....@........@@....@..
............................@.
