30,30
@....@........@.....@.........
.@@............@@..@@....@....
....@.........................
......@...@......@.........@@.
...............@..............
...@...@......................
............@..@.@........@@..
..............@...............
......@.......................
...........@.............@....
......@.@..@........@@.@......
......@....@....@.............
..@.................@.........
....@.....@.........@..@.@....
.........@......@....@........
.........................@....
@..@............@....@.....@@@
..............................
@..@.............@.@..........
..............................
.@...........@.......@..@...@.
..........@@............@.....
..@.......@.......@...........
..............................
@.................@...@.....@.
........@.....@...........@@.@
........@...............@.....
.@.........@..@....@...@......
......................@..@....
.......@......................
