30,30
........@...........@@...@....
@...........@.................
...................@.........@
@...@.............@...........
..............................
..@@..........@...............
.@.......@.......@............
....@...@.....................
...@...............@..........
....@.....@.@...@............@
......@............@..........
..@...@....@...@..............
..............................
.@...@..........@.......@.....
.@.....@...@..@...............
....@...................@.@...
..@.........@.@....@.@........
.@...........@........@....@..
..@......@..@....@.......@....
..@.@........@................
............@..@....@.........
.............@.....@@.........
......@..........@....@......@
...........@.........@........
...@...........@..............
.........................@.@.@
.....@............@........@..
..@..@..@.@...................
........@......@.........@....
.........@@...........@.......
