30,30
.....@..@.......@.........@...
......................@..@@...
..................@.@@........
@..........@@...@...@.@.......
.......@......................
........@..........@.....@...@
....@..........@.............@
....@.......@...@.............
............@.................
....@...@...........@.@.......
........@.....................
@.....@...@..............@....
...........@@@....@....@....@@
.......@......................
..@.....................@.....
...@..@................@......
.................@@.....@...@.
....@....@@........@..........
..............................
......@...@...............@...
.@.........@....@...@.........
.......@.@...@....@...........
..@.@........@@...............
@.........@............@......
............@.......@.........
..@@@.................@.......
..............................
......@.......................
..@@.....@.....@..............
..............@...@........@..
