30,30
........@.....................
....@....@....................
...........@..................
.........................@....
.@............................
......@...@.....@............@
.....@@.........@.......@.....
..@....................@...@..
......@.......................
.............@.......@.@.@..@.
.....................@........
@...............@...@.........
............@...........@...@.
.@.@...@................@.....
..@..........@......@....@...@
..@.................@@.@@.....
@.@.....@.....@...............
.@.......@...........@..@..@..
......................@.......
.....................@.....@..
@.....................@....@..
...@.@..@...@.........@@.@....
......@@.....@..........@....@
....................@.........
@@.@.......@@............@....
..............................
.......@..@...................
........@@..........@@........
.............@..@.....@.....@.
......@...........@...........
