30,30
.@...........@.......@........
......@..@....................
............@....@.@.@...@....
.@................@....@......
.....@.@...@..................
.....................@........
@....@...@.......@.........@..
.@...@..@........@............
................@.............
.@.......@@...........@.......
...........@...@.........@..@.
.............@....@.........@@
@....@@..........@.........@..
.........................@....
....@@.@.........@............
...@...........@..............
@......@@@.....@..............
.........@...@.............@..
..@...........@.......@.......
.....@.........@@...@...@.@...
......@.....................@@
.................@.@..........
..@...........................
............@......@.......@..
......@..........@.........@..
.............@................
..........@.........@....@....
............@............@....
......................@.......
..@.@...................@.....
