30,30
................@.............
@@@@.......................@..
........@.....................
.....@........@............@..
...@....@...@........@........
.....@@.....................@.
@.......................@@...@
..@..................@.......@
..........@.@......@........@.
..............................
.................@......@....@
........................@.@...
@..........................@..
........@.....@....@..........
..........@............@...@..
...@.@.@.............@.@......
..........@....@@.......@.....
..@...........@.......@.......
...........@@@.......@..@.@...
.@..............@.......@.....
.............@................
............@..@.@...@........
.......@...............@......
@.....@.............@@.....@..
...@...................@...@..
............@..@..............
.....@....@............@......
.......@...............@......
.............@....@..@....@@..
...........@..................
