30,30
............@...@.............
..@.....@..@...@@.............
......@......................@
.....@....@....@...@...@.@....
..........@..............@....
.....@............@...........
......@....@................@.
................@.............
.@..@.......@................@
.....@........................
...@..........................
@.......@......@..........@@@.
..@..@........@...........@...
....@.@.@.....................
..@@..@......................@
...........@.....@@...........
..............................
.....@.........@..@.......@...
........@.@....@............@.
..........................@...
...@.......@............@...@.
..........@..@................
.....@.........@..............
..............................
.@...@......@......@..@..@....
..@.........@@...@.@..@@......
@..................@.@........
..............@......@@.......
.@................@.@........@
.@............................
