30,30
..@.@.........................
.......@.......@..............
......................@@......
...@.......@.....@...@...@....
@....@...............@.@......
@.....@.........@.@......@....
...............@.....@........
......@.....@.@@......@......@
.....@.......@....@@..........
@..@..........@...............
........................@.....
.....................@...@....
.................@@...........
.........@....................
..............................
.@@......@..@.................
.........@...........@........
....@........@.@...@...@......
...........@....@.@....@@.....
.........@...@@........@.....@
@.......................@...@.
.@..........@............@@...
...............@....@.@@...@..
..@...........................
....@...@..............@......
........@..@............@@....
....................@....@...@
..............................
.........................@.@@.
...........@...............@..
