30,30
.......................@......
...................@......@...
..............................
......@.....@............@..@.
...............@....@@........
............@...............@.
..............................
@.@........@...@.....@........
.@...@...........@..@.........
...........................@.@
.........@......@......@....@.
.....@.................@.@....
....................@....@..@@
..@..@..@.........@...........
........@...........@..@..@...
.@.........@...........@......
.........@...@.....@..@...@...
.......@.....................@
...@.........@....@.@@........
..@.@.........@...........@...
..................@@..........
...@.........................@
...........................@..
......................@..@@..@
....@.@......@.............@..
..............@....@...@@....@
........@....@................
...@................@.........
.........................@...@
@.......@.@.@.@...............
