30,30
.....@..@...@........@........
....@......@........@.....@...
............@..........@.@....
............................@.
........@...........@..@....@@
............................@.
..@.@...@...@.................
.....................@........
.....@..........@...@.@.......
.@..@.........@...@....@......
.........@....................
.......@....@....@..@..@.@.@..
@....@........................
.......@..........@...........
.......................@......
........@....@...@............
@.........@............@....@.
..............................
..@...@....@......@@.........@
@.................@...@.......
........@......@...@@.........
................@.............
.........@....@........@......
..@...........@....@..........
....@.........@...............
@..............@........@....@
@.....................@.......
.........@..@...@@..@......@..
.............@................
@.........@...........@.......
