30,30
.........@.@..........@......@
.............@...@@.....@.....
..............@@..............
........@..............@@.....
.............................@
.@..@@.........@@...@.....@@..
.....@................@.......
..@@.......@..................
...........@..@.@@.........@..
......................@@@.@...
..@.......................@.@.
...........................@..
@............@..@.............
...@......@...................
..........@...@.....@......@..
.............@@...............
...........@........@.........
.......@.....@.............@..
...............@.@............
...@...........@..@....@.....@
...@..........................
....@.........................
..........@@.@....@@.@......@.
.............@.........@......
......@.....@.....@........@..
.....@..@....@..@@.........@..
...........................@..
............@...............@.
...........@..............@...
....@.........................
