30,30
@........@...@.@.......@.....@
.........@............@.......
.@............................
.@.....@..@...@.@.............
.@@...@@....@....@.@.@....@..@
...............@......@.......
.......@@.....................
@....@.....@..@@..............
..@..@....@..........@...@....
..............................
.....@................@.......
......@...@..@........@.....@.
........@.............@...@...
.......@.......@.....@........
...........@.......@..........
.............................@
...................@......@...
..@......@..@.........@.......
..@...@..@.............@..@...
..@..@..@.@............@......
..........@......@..@@........
......................@.......
..............@.............@.
........@.........@.@.......@.
.........................@....
..@...........................
.......@..................@...
.......@........@...@.........
..............................
...@...@......................
