30,30
.......@......................
............................@.
.....@........@...............
....@...........@.@...........
..@...@..@....@.....@.......@.
.@.@............@..........@@.
......@.....@...............@.
..........@.@....@............
@..........@....@.............
.......@..................@@..
.......@.@....................
....@..@..........@.....@.....
........@.....................
...@....@.........@........@..
......@@......................
@.@.........................@@
.......@.@..........@......@..
..........@....@....@....@....
.............@.@..............
............@..............@.@
...................@.@........
......@..........@....@...@...
@@..............@.......@.....
........@.....@.@............@
@.........@...................
..@...........@...............
...........................@..
@@@................@...@.....@
.@.......................@....
.................@.......@..@.
