30,30
@................@....@.......
...@..........................
.....@..................@.....
.....@...........@............
....@.....@@....@..........@..
...........................@..
...................@...@......
@.........@................@..
.................@.......@....
.....@..........@.............
..........@...................
...........@@....@....@.......
.....@............@...........
...........................@..
..............................
..@@@......@........@......@..
......@.......@........@......
..............................
..@...@......................@
@................@..@.....@..@
....@.....@.@.................
.....@............@......@.@.@
.@...............@..@@...@....
...............@@.@@...@......
...@..@@...................@..
....@...........@..@.@........
...@..@.@..........@......@...
@....@..........@...@.@.......
....@.........................
.@.......@.........@.....@...@
