30,30
...................@..........
.....@............@@...@......
..@..@......@..........@......
..@.@...@....@..@@.........@..
.........@...........@.....@..
..............................
.....@..............@.........
@.........@........@..........
.........@....................
@..........@...........@......
.@.....................@......
..@@@.@.@....@................
...............@....@.....@...
.................@........@...
....@...................@..@..
..............................
...........@..@......@........
...@..........................
....@...........@.........@...
.....@.@................@.....
@.@.....@......@......@..@....
@.@....@.......@.@..........@.
..........@.......@@..........
..........@...........@.......
@..........@....@...@@........
...@....@.....................
..........@..........@........
@......@.....@........@.....@.
..............@....@.........@
....@..........@..............
