30,30
...@.........@........@...@...
.@...@...@.................@..
.................@............
............@@.........@..@...
@@..........@.........@.......
...........@............@...@.
......@...........@.....@.....
..............................
..@...@....................@..
...........@...@.......@......
............@..@..............
...........@......@........@..
@...@........@.@@.....@.......
.....@..@....@................
.....@......@.................
...........@..@....@.........@
.@............@@.......@......
...........@..................
..............@.......@..@....
.........................@....
...@.....@.@....@.......@.@...
....@......@.........@........
......@.@.....................
...................@..........
.......@...@.@.@.@..@.........
.........@.........@.@.....@..
@.............................
.@......@...@.................
....@@.....@.....@............
.........@...........@........
