30,30
...........@.......@..@.......
...................@.....@....
....@...@............@........
.....@....@...........@.......
.........@......@.............
.........@.@@.........@@....@.
....@............@.....@..@...
.........@.............@......
......................@.......
....@............@............
........@@.........@..........
..............................
.......@......@..............@
..@....@.....@............@...
@.@@...........@.....@.......@
...........@..............@...
.....@......@.........@@......
.........@.....@.@.@..........
..@....@.......@.@............
...@..........@...@........@.@
..............................
@...............@@.@..........
@.....................@.......
...@..........@...@.@.....@...
@.......@.....................
..............@....@..@.......
.@..@............@..@.....@..@
@...........@....@............
.......................@......
.....................@........
