30,30
....@@.....@@.....@...........
.....@...@......@.........@..@
..........@@..................
..@....@...@...@..@...........
..............................
..............................
..@..................@......@.
.@.........................@..
...............@..............
.....@..@....................@
.....@...............@......@.
.......@......................
@.........@.@@@...............
..............................
...@.......@..............@...
............@..@..............
.........................@....
.@@............@..............
.@@.@......@@..@..........@.@@
...@@........@....@...........
......@.@.@......@@...........
@..............@.......@......
........................@.....
.....@..@.................@...
.....@.@..................@...
..@@.....@.......@.........@..
..................@.....@.....
...........@.......@.......@.@
..@..@..@..............@@..@..
.........................@....
