30,30
.......................@......
....@.................@.....@.
..@....@......................
..@.....................@.@...
.....@...................@....
.............@......@...@.....
.@.@.....@...@......@.........
......@.................@@....
.............@............@...
......@..@.....@...........@..
@........@........@...........
...................@......@@..
...........@@........@....@@..
......@...@..........@.@...@..
..............................
..........@.........@@........
..@.@@.....@.....@......@.....
........@........@@...........
...@............@.............
.........@....@.......@..@....
...........@.@....@...........
.....@..@.....................
...........@..................
...........@@..@@.............
.@...............@....@....@@.
..........@..........@......@.
...@...............@....@.....
@....@.@......................
..........@....@............@.
..@...........................
