30,30
................@...@....@....
..@......@..@.....@..........@
.......@....@....@.@....@.....
................@.............
..........@........@.....@..@@
.......@...@.@.....@.......@.@
..............................
@.......................@.....
..........@.@....@......@.@...
@.........@.....@.@@.@........
.....@@.......................
@....@...........@............
.........@....................
..@..@..@....@................
.....@........@...............
.................@.......@....
.@...@..@..........@....@.....
.....@.....@.@.......@........
.......@....@.....@...........
.@.........................@..
@.....@........@..............
.@............................
.........@.............@@.....
.@..................@.........
.@..@............@....@.......
.....@.......@............@...
................@.............
......@..@....................
..@.............@.............
.................@@...@.......
