30,30
...............@......@...@...
....@@....................@...
....................@.........
..@...........................
@.............................
.....@.@.@.....@@.............
.......@.........@....@.......
....@.........................
.@.....................@....@.
..........@@.......@...@......
........@..@..................
@...@@.....@..................
.@.........@@...............@@
...@.....@....@.@........@....
.......@....@..@...@@.........
...........@....@.............
.............................@
.......@@.........@.@.........
........@......@..@......@...@
...@.....@............@..@....
.............@................
.....@.............@..........
.....@.@...@..................
..@.@...@.....................
.............@......@......@..
..@......................@...@
....@.......................@.
......@..@..@..@..@....@..@.@.
...............@..............
........@.........@...........
