30,30
...........................@..
.@.@........@@.@..............
..........@.......@........@..
.....@....................@...
.......@......................
...@.....................@....
.....@.............@..@.......
........@.......@.....@.......
....@..............@@.........
.........@......@.......@.....
.................@..@..@@..@..
.@@@..........................
....................@.........
.....@...@.....@...@..........
@.............................
...........@............@.....
.@.@..................@....@..
....@......@..................
@...@..@....@@.....@..@.......
..........@.@........@@.@...@@
@.....@..........@...@@.....@.
.@.@..................@.......
.........@...@.....@..........
....@..@.@..........@.........
......@.................@..@@.
......@.......................
..............................
...........@..................
.@...................@........
.....@....@..@......@.........
