30,30
.............@................
......@....@...........@.@....
.............@....@.......@...
....@@....@...................
....@..@...@.@......@......@..
...........@.....@.........@.@
.........@....................
.......@.......@.@.........@..
..............................
@.@...........................
.................@............
....@.@..@.............@......
................@......@......
..@.....@....@.......@........
................@...........@@
..@......@....................
...@...........@...@..........
.......@....@...............@.
.@.@............@....@........
@..@.......@.......@..........
...........@....@.............
..@......@...@.....@..@.....@.
...................@...@.@.@..
....@....................@....
....@.........@..@..@.......@.
...................@..........
..............@@.....@.....@..
...@......@...................
.......@..@...................
......@..........@....@......@
