30,30
.@............................
....@...@.....................
........@........@..@...@..@..
....@...........@............@
...@.@.@................@@....
......@........@....@.........
....@.......@.@...............
....................@.....@...
.........@.@.@.........@.@...@
....................@@.......@
........@.......@.........@...
...@.......@.................@
..@@........@...........@.....
...............@.......@...@..
...@..........@...............
...................@...@..@...
..........@...................
..............................
....@.........@...............
.@..............@.......@...@.
.................@.....@@.@...
..............................
.@.@................@.........
....@.....@...@............@.@
.@................@...........
.@........@......@............
..@...@...............@.....@.
...@.................@@@......
..@@@.@....@.........@........
......................@.......
