30,30
.......@..........@...........
...........@.........@.....@..
.....@................@.......
.@......@......@.@..@.....@@..
.@........................@.@@
..............................
......@.........@.......@@....
..............@..@.@.......@..
..........@..@................
.............@.......@........
................@......@......
.......@........@@.@......@...
.............@....@.....@@.@..
..........@@............@.....
........@...@......@.........@
..@...@.......@.@.@@.@........
..............@...............
.....@........................
@.................@..........@
.........@.................@..
..@......@.......@............
......@@......................
@....................@......@@
..................@...........
...@@.@......@.....@........@@
.........................@....
..............................
...........@.@.............@..
..@........@..................
.......@@@.................@..
