30,30
..............................
......@..@................@...
........................@.....
@@.................@@.........
..@..........@...@...........@
......@.............@......@..
....@...............@.......@.
...@......@.....@.............
.@.............@@..@..........
.@..........@....@@.........@.
..........@@..........@.....@.
....@...................@..@..
@...............@.......@.....
............@...@.............
.......@....@......@....@.....
..@..........@.@..............
@.@.......................@...
........@......@...........@..
..........@.........@.........
......................@@......
.......@...............@......
..@.....@@.....@.........@..@.
...........@@....@@...........
...................@...@......
.......@..@......@...@........
.....@.........@....@...@.....
.....................@..@.....
........@..........@..........
....@.@.......................
...........@.@...@............
