30,30
...................@..........
...................@.....@....
.....@..@@......@.@........@@.
...@.@..........@......@......
.@........@@..................
...........................@..
.......................@......
..@........@..............@@..
........@.....................
.@............................
.................@@...........
.@..............@.....@.......
........@..@@.................
...@...........@@.........@...
......@...................@...
..........@.@.@...@@@..@.@....
..................@...@.......
.......................@......
..............................
...@..............@.......@@..
@....@@.@.@...............@...
.....@............@...........
...@..........@...@@..........
@......................@@.....
.@.............@...@..........
...@..@....@@..@@.............
..@..@......................@.
..@...........................
.....@@....@...@..@..@@..@....
..............................
