30,30
.@........@....@....@.......@@
..................@@.....@@...
....@..@......@...@...........
........@....................@
......@...............@.......
....@...........@...........@.
...@...@.......@.......@......
................@@............
.........................@.@..
........@@......@.............
....@@....@...................
.........@....................
@..........@..................
..@.@........@@........@......
....@.....................@...
.......@..@...................
...@........@....@...@.@......
@....@...................@....
.......@..@......@@.@.........
.....@.@.........@....@.......
......................@.......
...@..........@...............
@.............................
......................@......@
..@........@......@.....@.@...
..@...................@@......
.........@....@...............
..@....@..........@....@......
.......@......................
@....@.........@.@.......@....
