30,30
..............................
................@.....@.......
.............@..........@.....
..@......@@...........@.......
..@..@.....................@@.
..............................
...............@......@.......
............@...........@@....
..............................
......@..@....@........@.....@
............@.....@...@.......
......@.....@...............@.
.......@@.....@...............
.....@..@...@.@.......@.......
....@....@....@.......@.....@.
...@.@..................@.....
.@..........................@.
@@.................@@.........
........@@.@......@...........
@....@........................
..@........................@..
...@......................@..@
..@......@.@.............@...@
............@........@.@......
....@.............@@..........
.....@......@..........@......
....@.........@....@@......@..
.....@.........@@.........@@..
.....................@........
....@..@...........@...@......
