30,30
..........@..............@@...
.................@...@...@....
.@..........@.................
....@..............@....@.....
..........@.........@@...@....
....................@.....@...
...@....@@.............@@.....
.....................@........
...............@.@@.....@.....
..................@@.......@..
.........@....................
...............@..............
............................@.
.@......@............@........
.........@.................@..
@....................@........
...@..@...............@.......
@.@...@.@....@.....@..........
......................@@......
.............@.@..............
............................@.
..@...........................
@...@................@.@......
@...@.......@...@........@....
...@.@........................
.@.........................@..
@..@..........@.......@.......
@............@@..@...@..@.....
........@.........@.@.....@..@
@......@.......@.@@.....@....@
