30,30
....@...@...............@.....
..@...............@......@....
@...@.......@..........@.@....
...@...@.....@................
......@.......@..@..@..@......
.@..@.........................
............................@@
.....@.@.................@...@
..........@............@......
............@.................
@..........@@......@....@.....
.......................@@.@...
....@....@....................
................@..@..@..@...@
..............................
.......@..@............@....@.
.......@.@............@@...@..
.............@......@.........
............@.....@...........
..@...........................
..............................
.............@.@..........@...
.@...@..............@....@....
................@....@..@.@...
................@......@......
..........................@...
......@@.....@..@.@....@.@....
....@.........@...............
...@.......@........@..@.@....
.......@.......@.............@
