30,30
.............@................
.....@.@...............@@.....
@.@.....@......@..@........@..
.@...........@.......@........
........@.@..........@...@....
.........@.......@@.....@.....
@.....@......@......@......@..
.@.......................@...@
............@......@@........@
...@....@...@.............@...
...@...........@........@.....
.....................@........
...@..................@.......
...@..@.......@.@..@..........
.........@..@.@..@...@.......@
..............................
.....@........................
...........@....@...@.........
........@................@....
....................@...@.....
............@.................
...........@..@..@.........@..
....@...@.....................
.............@.........@.@..@.
..@..........@................
................@.@....@@@....
......@.....@.........@.......
..........................@...
@.................@........@..
.........................@..@.
