30,30
................@.............
@@..........@.................
...@........@.@.@...@@........
............@....@............
@......@.@.........@..........
.....@.......@.......@......@.
.......@..........@..........@
...@.............@...@........
..........@...................
......@....@...@..@...........
..............................
..@@..@...........@.....@.....
..@......@....................
@....@.................@....@.
...@......@...@.....@.........
.....@.......@............@...
@......@..........@...........
........@@......@.........@...
..@..........@................
...@.............@....@.@.....
..............@...@......@....
.@..@..............@..........
.....@@.......................
...@.@..@.....@...............
..............@...........@.@.
....@..........@@@..@.......@.
...........@.....@............
............@........@........
................@............@
.........................@....
