30,30
.......@.........@...@.@......
........@..............@......
.@..........@.@...............
......@........@........@..@.@
.....@..............@...@.....
..@.......................@..@
..................@@@@........
................@..@........@.
.............@..............@.
.........@..........@..@.@....
..@.......@......@.........@.@
@..@........@..@.....@@..@....
.....................@.....@..
....@............@.@...@......
@........@.......@.@@..@......
.........@....................
...............@.......@...@..
............@.................
................@.......@....@
.....................@.....@..
............@.@..@.......@....
...@..........................
..@...............@....@......
..@.................@.......@.
.......@......................
...............@..............
......@............@..........
@......@..........@...........
..@......@.....@..............
.........@............@.......
