30,30
......@@...........@..........
...@........@.................
.................@.@..........
..............................
@...@.........@........@......
..............@@..............
........@.....................
.@......@....................@
.........@@@.......@...@......
......@.......................
............@@.@...@...@......
...............@.@............
.@.................@..........
.......@............@.........
......@.@.....@..@@....@...@..
...@..@.......@.@..@..........
..........@.@..........@......
......@.......................
..............@.......@.....@.
..@.@.......@.................
............@.................
.....@.@@...@....@@@@........@
.............@..@.@...........
..@...@........@......@..@....
...........@.@................
..@@...............@..........
.........@..@..@..............
@...@......@............@....@
.........................@....
...................@.@........
