30,30
@..........@...@.......@@.....
.........@...................@
...........@....@.............
..........@.@.@..@@...........
...@.@....@...@.........@..@..
...........@..................
.@...........@...............@
..................@...........
........@..........@..........
.......@@...............@.....
...........................@..
................@........@@...
.....@.............@..........
................@....@...@..@.
...@...................@......
......@@@.................@...
.....@..@.......@.............
@......@.......@........@.....
...........@............@.@..@
......@........@............@.
...........@..@..@............
................@.............
...@.......@....@.............
@.............................
.............@..........@...@.
....@......@@..@..@.@.........
...@..@........@....@....@....
..............................
.....@..@@.....@......@.@.....
...@............@.............
