30,30
.....@....@....@.@...........@
...@.........@................
..@....@...................@.@
.....................@.....@..
........@.@....@..........@...
..........@...@...............
@.......@......@@...@......@..
@..@..........................
...........@.....@............
.......................@......
..........@...........@.......
......@................@..@...
..@..@..@...............@.....
.................@.........@@.
...................@.@........
...@..............@@.@........
....@..@..@...................
..@.........@.@..@............
@...........................@@
.@.....@...@...........@......
.@......@..............@..@...
.....@....@..........@......@.
..............................
................@........@....
......@.......................
...........@.....@............
.............................@
..@......@.............@......
@...........@.........@.....@.
..@..........@@.@.@.@........@
