30,30
...................@.........@
.............@...........@....
.@............................
@......@.....@..@.....@.......
......@..@.............@...@..
..@.....................@.....
......@@...@@...@.............
.............@................
...@......@.......@..@...@....
.........@.........@..@.......
....@@...@....@.@.@.@.@.......
.......@..............@@...@..
@@........@...................
...............@.@............
.....@......@.................
................@......@......
@...@.@...........@.....@.@...
...................@........@.
...@........@.............@.@.
.................@....@..@...@
.......@.............@@.......
.......@...............@@.@...
@.@...@..............@........
..................@...........
.@.....@...@.......@..........
......................@.......
...........@....@....@........
...........@........@.........
..............................
................@.............
