30,30
.......@.@..@..............@..
....@...............@.........
.@.................@.....@....
..............................
.....@........................
...@........@..@..@.......@..@
.............@.............@..
....................@..@......
..........................@.@.
...............@....@.........
.@.........@..................
.................@.......@@...
..................@@.@..@.....
...........@@............@....
.........@......@@@.........@.
........@........@............
............@.................
.........................@.@@@
...@....................@..@..
..............@....@..@.....@.
...@........@........@........
..@........@........@.....@...
....@.@....@...@.........@....
............@.....@...@@.....@
......................@.@.....
........@.......@........@....
........@.............@..@....
.......@......@...@...........
........@.@..@.....@..........
..@.........@...............@.
