30,30
@.........@.......@...........
@..............@....@..@......
......@....@..................
...@@..@.............@.@.....@
..@................@..@.......
...............@.@@.....@.....
.........................@....
....@....................@....
........@.......@..@......@...
.@........................@...
.........@.@.............@....
@........@.......@.@.@........
....@..@.......@....@...@.@...
.......................@.@@@..
...........@.......@..@.......
..............................
....@......@.......@@.........
.......@.....@...........@....
..............................
...@..................@.......
.@.@.......@.....@............
..............................
....@........@........@@......
@.......................@.....
...@........@.......@@........
........@........@.........@..
..............@......@...@...@
.....@..........@...@......@..
..@.......@@..................
.............@................
