30,30
..............@............@..
...@....@..@..........@...@...
......@................@......
.........@@.@..@.........@....
........@..@..................
..@...........................
.......@....@.........@.......
@......@..............@.......
..........@...@...@...........
.@.....@.@@..@..@@..@.........
.....@........@......@........
..........@....@..............
..@.............@..@..........
..@......@@............@......
....................@.........
..............................
...........@.......@.......@..
.@@.......................@...
..@..........................@
....................@......@..
..............@...@.....@@@...
.......@..@........@.....@....
.......@@...@.................
.............@..@..@..@.@.....
...........@.@................
.............@................
@.......@................@....
..@.....@..@..@....@..........
.......@..@......@.........@..
............................@.
