30,30
.@.@..............@.@....@....
....@..@.............@@.......
.@..................@.........
...............@.........@..@.
.......@......@@..........@...
...@...@..@...................
@......@..@.......@...@...@...
.............@................
@.......@....@.@......@.......
..............................
...@..........................
..@...@...........@..@....@.@.
......@........@..............
......@...@@@.@..@......@.....
.@.............@@.............
.@.@.@........................
....@.@.......................
@...@.......@.................
...........................@..
@.........................@...
..........................@...
.@...............@.......@....
....@..@............@...@...@.
............................@.
..@............@........@.....
.........................@....
.@..@........@........@.....@.
...@...........@...........@..
.@.....................@......
.........@....@......@........
