30,30
...@....@.....................
........................@.@@..
.........@.......@............
...............@.......@......
.........@....................
.....................@......@.
.@.....@.........@............
..........@...................
....@.........................
@.@@.@...@....................
...................@...@......
.@..@..........@...@..........
....@....@........@...@.......
..............................
....................@..@......
....@.@@..........@...........
...@...........@@.@...........
.......@....@.@...........@...
...@@.......@.......@....@...@
.................@...........@
......@....@..................
@...@.....................@...
...........@.........@.....@..
@........@..@.................
@..@..@@...............@....@.
....@......@......@.....@@....
..............@............@.@
@.....@.@...@............@....
........................@@....
.@.........@...........@...@..
