30,30
.@.@..........................
............@....@...........@
......@.......................
...........@..@..@..........@.
...@......@....@.......@......
.............@..@...@.......@.
......@@..................@...
....@.....@...........@.......
@.......@............@........
..................@...........
@.........@...........@.......
..............@..............@
.......@...................@.@
.@............@..@...........@
.............@.....@..........
.@....@...@....@..@.@.@......@
..@...................@..@....
.......@..@...................
...........@..........@.......
......................@.......
....................@.........
................@@.......@....
..........@......@@......@....
@...@......@.@.........@...@@.
........@....................@
.@....@...................@...
@..............@@..........@@.
..@.......@................@.@
.......@.........@............
...........................@..
