30,30
...........@..................
.............@.............@@.
.......@............@.........
..........@...................
................@.............
.........@....................
.............@........@.......
@.@..@...@.......@.@@........@
..@.........@.......@..@@....@
.....@...........@...@........
........@...@..........@......
........@.......@........@....
.........................@....
............................@.
.@@....@.......@.....@........
.@.@....@..............@...@..
..........@............@......
.....@@........@........@.....
........@........@...@@.......
.......@.........@.@.......@.@
..............................
@..@..........................
@.............................
.......................@......
....@@...........@.......@..@@
.@...@....@...@.@..@...@..@...
..@..@...@...@......@.......@@
..............................
...............@..............
....@............@...........@
