30,30
......@...@.......@....@......
......@..@.@..@.....@....@....
.............................@
@........@..............@..@..
.......@..............@@......
@@@...........................
.........@@.........@.........
............@.................
.........@..@@........@.......
.@.....@.@.@.....@......@....@
....@.@........@..@..........@
.......@......................
......@.......................
..............@......@........
...@........................@.
.............@...@.@..........
@..................@..........
..@@.@........................
.........@..@.......@@........
........@...................@.
.@.@.............@...........@
.......@......@@.@............
......@......@...............@
...........@..................
.............@..............@.
....@@........@@.............@
................@....@@....@..
...@......@...................
...@.........@....@...........
............................@.
