30,30
.@.........@...@..........@...
........@..@..................
.......@.............@@.......
.................@@@..........
....@........@............@...
.......@.@..............@.....
....@.........@.......@.......
............................@.
...@.......@......@......@....
.......@..@.........@.........
.@....@..............@@.@.@...
..@.........@....@............
..@...........................
.............@..............@.
.@................@...........
...@.......@.......@........@.
..........@.@.....@...........
.@@....@................@.....
..@..................@........
..............................
.@..@.............@...........
.@..........@....@@...........
...................@..@..@..@.
.................@@.@.....@...
....@...............@........@
.@....@@......@@...@.........@
..@...@.......@...............
.@@........@..................
.......@..@...................
........................@.....
