30,30
@....@.......@.@....@@........
..........................@...
.................@..@....@....
................@.........@.@.
.........@......@..@..........
..........@.@..@........@.....
....@........@................
..@.....@.........@..........@
.@......@......@....@......@..
..@.@.......................@.
.........@...........@........
...@..@.......................
..............................
..............................
..............................
...@........@...........@.....
...@............@.@@.@..@.....
.................@..@@........
.......@............@.......@.
....@..........@.........@....
@.......@..@......@...........
...........@.......@...@......
..........@.....@....@.@......
..@...........................
..........@.............@.....
..@................@@........@
...@.@..@.......@.............
....@....@........@......@.@@.
................@@..........@.
....@.@.@.....................
