30,30
............@...@..........@..
.........@..............@.....
...@...............@..........
@........@.@..@@..............
...@...............@..........
.......@@.@....@..............
.............................@
...........@..............@...
........@.....................
..............@@..............
............................@.
.........@..@.@...@....@......
...@...........@..@.........@.
........................@.....
......@....@...............@..
.......................@.....@
@...@.......................@.
......@...@......@............
..@....................@......
......................@@@.....
...@.@..@.....................
.................@...@........
.@.......@..@...@@.......@...@
....@@........@@...@..........
......@.@.............@@@.@...
..@........@..@...........@...
.@.@....................@@..@.
....@................@........
.............@..........@.....
@......@.................@....
