30,30
....@....@.............@..@...
.@.........................@.@
.@......@.@...................
..@....@.......@..............
................@.............
.....@.................@......
...........@........@.........
@.............................
@.@@......................@...
..............@....@@@...@..@@
.........@....................
....................@....@....
..............................
@.....@...@..@@@.......@....@.
@...........@.................
@...@@.....@..................
...@.@@.............@.........
..............................
@..................@...@......
..@........@......@...........
..........................@...
.@...........@.......@.@......
.....@..@.............@.@.....
.....@................@.......
.......@......@.........@.....
....@.........@..@.@..........
...@......@.....@.............
.........@..........@....@....
.@.@............@......@@.....
..@.......@...........@...@...
