30,30
.......@...@@@...@.......@....
.@......@.@..............@....
..@.@............@@...........
...........@..................
..............................
@.........@...@.......@.......
@...@.@......................@
.......@.....@..@.............
.@.....................@...@..
....@.........................
.................@............
@..................@...@......
..@........................@..
..............................
...........@........@...@@....
@.@................@.@........
....@..........@..@@...@@.....
.@.@..........@.....@@....@...
..................@..@.@..@..@
...@........@.................
...............@....@..@......
.....@......@..@.......@......
.............@.......@@.......
.......................@......
@@.....................@.@..@.
........@.....................
..................@...@.......
......@......@@.@.........@...
..............................
...........@.@...@............
