30,30
@..........................@..
........@...@............@....
.........................@....
.@....@.......................
.@...@..@...................@.
.....@...@........@...@.......
.......@.@......@........@....
.@....@.....@...@....@........
........@@......@..@..........
.@..........................@.
@..........@...........@..@...
..@........@@...@@..@.........
.@..........@...............@.
..................@.........@.
..@.........@.............@...
.....@....@...@...........@..@
.......@......................
............@.@.......@.....@@
...........@..................
......@@..@.............@.@...
..............................
.@.@..@.......................
...@..@.......................
.@@@..........................
............................@.
......................@...@...
.....@.....@..@...............
.......@...@@...@.............
...@@@......@.................
...@.......@..................
