30,30
................@.............
.@.........@@..@@.............
..@..@..............@@....@...
.............@.....@......@..@
........@....@.............@..
....@.@..@....................
......@@.......@..............
.@...............@...@........
....@..@.............@........
.......@....@.....@....@.@...@
........@.........@..@..@....@
@...........@@......@..@......
....................@.........
...@....@.......@..@.@....@...
..@...........................
........@..@..........@.......
............@...@.............
.........@...............@....
..............@.......@.....@.
..........................@...
..........@...............@..@
..@.................@....@....
.................@....@.......
....@..@.................@.@..
.........@..@.................
................@.........@...
...................@.......@@.
...............@@.@...........
..........@...................
...@..........@...............
