30,30
................@.........@...
...................@..........
...........@@.@....@.@........
.@.@.@..............@.........
.@@............@...@...@......
.................@.....@..@...
..............................
........@.@.........@.@...@...
..@....@...@..................
..@..................@@..@...@
..@.....@....................@
...@.......@........@.........
...........................@..
..........@.............@.....
..........@...................
...@......@........@....@....@
..@......@............@...@..@
...@..@..............@.......@
.......@@....@..@.......@.....
...@....@..................@.@
..@@.....................@....
....@............@.@.@.@......
...................@..........
..............................
@.................@...........
...........@....@.............
......@......@................
..........@.....@...@....@....
.......@.............@........
....@@................@.......
