30,30
.....................@........
..........................@...
@..@...............@@...@.....
...........@.@..........@.@.@.
..........@............@......
.@................@...........
...@.................@...@....
.....@................@......@
........................@.....
@....@...@..............@..@..
.....................@.......@
...@..........@.@...........@.
.@....@@...@..................
..........@..@.........@......
...@.@.......................@
...........@....@.........@...
......@@...@.......@..@..@..@.
...@...................@@.....
..@....@......@...............
........@..............@.@....
.....@........................
............@.................
........@@................@...
...@....@....................@
......@.............@...@....@
...@.@....@.@...........@.....
..........@.@......@..........
....@...@............@.......@
..............@...............
....@.....@...................
