30,30
.....@....@...............@...
............@....@@...........
...............@............@.
.................@............
@............@....@.....@.....
.....@...@..................@.
..@...............@...........
....@...........@.............
......@....................@..
........@...................@.
.@...@.........@.....@........
..@...........................
..........@@....@.......@.....
...@............@.............
.........@....@.@...@.....@...
......@.............@......@@.
.............@.......@@..@....
...............@.@...@........
..............@...........@...
........................@....@
...........@......@...........
........@.........@...@.......
...............@..............
..........@.@................@
.......@....@........@@.......
...@...@.......@.......@.@....
....@......@...@.....@@....@..
......@...@........@..........
.......@.@.@....@.............
.......@.@.........@.......@..
