30,30
@...........@.@.....@....@....
..@.........@......@......@...
@.@.....@.......@.@...........
..............................
..@....@...@..................
...@.....@....................
...........@..................
................@...@........@
........@......@..............
.@.....@......@.........@.....
..........................@...
@..@.....@...@...@..@.........
....@@........................
...@........@.....@...@.@.@...
.....@........................
..............................
@...........@...........@.....
@............................@
...................@@@........
................@...........@.
@.......@....@..........@.....
.@...........@.......@........
............@.....@..@....@...
.............@........@....@..
@@@..................@@.......
...@..................@@......
.@...@.....@.........@........
.....@@.........@@............
.........@.....@@.............
..@.................@.........
