30,30
........................@.....
..........@@.....@............
...........@....@@...@.@......
..........................@...
@@.......@.....@...@..........
.....@@...................@@..
@.......@..@.......@..........
............@........@........
....@.............@@...@......
.........@.......@.@.@........
...................@@.........
..........................@...
........................@.@...
...@........@...@.....@.....@@
.........@.@..................
.............@.........@......
...@...@...@.............@.@..
.............@................
.............@.............@..
...@.@........................
.....@@..@@.@.....@..@.....@..
.........@.@.....@..@.........
.................@.@..@.......
.....................@........
.......................@......
.........@.@........@.........
@.................@......@....
.........@......@.............
@.@...@.......@........@......
..........@..@................
