30,30
..@....@@...........@...@....@
.....@.....................@..
.@.@.....@@.@.....@...........
...@...@......................
.......@........@..........@..
@..@.....@......@..@...@......
..........@........@.......@..
...........@.............@....
...@..........................
@.@...........@..........@@...
@...........@.....@...........
.....@....@@..............@...
.........................@..@@
..........@@..@...............
....@.......@.................
....@....@.......@...@@.@.@...
.......@...........@.....@....
.....@@.......................
...........@..................
....................@.....@...
..........@.........@.........
..........@........@..........
................@.............
.@...........................@
......@..................@....
.................@............
..@@.......................@..
....@.................@.......
....@..................@.@....
.....@@.......@@...........@@.
