30,30
......@.......@.....@..@...@..
................@@.@..@.......
@...@...@.......@.@...........
.@.......................@....
..............@........@...@.@
....@....@..........@.........
.........................@...@
..@....@...@......@..@@.......
..................@.....@.....
..............................
.@............................
..........@.......@...........
........@.@.....@.............
....................@.@.......
...@.@.....@......@...........
.@..@....@.....@....@......@..
...........@@............@....
..............................
.@................@.....@....@
@..........@............@.....
.@...................@.......@
.......................@......
.....@........................
..............................
@...........@.@@.@............
..........@..@...........@....
@@...@.........@.....@........
.....................@@@..@...
..................@@@.........
.@...@.@....................@.
