30,30
@@..................@.......@@
@...............@..@...@......
............................@.
..@......@.@......@.....@.....
.................@...........@
..............................
.................@............
@.....@.......@...............
@....@..@....@..............@.
...@..@.@..@........@.....@@@.
..............................
..................@@..........
....@............@........@@..
.......@......................
..........@..@.@...@..........
........@.....................
.......@.@.@@.....@.@.........
.....@....@..@...@............
........................@.....
.............@.@..............
....@....@.@..................
.....@.....@............@@.@..
...........@..................
........@.............@.......
...@.......@........@.@......@
....@.@..................@@...
.....@@..@.@..................
................@.@...........
...........@....@............@
............@@................
