30,30
..................@...@.@.....
......@.......................
........@.....@.@.........@.@.
@........................@....
@.@...................@.....@.
.@.@........@............@....
......@.@.......@.........@...
.....................@........
..........@...........@.......
...@.........@................
.....@@..@.......@...........@
....@.@..@.@@....@...@..@.@...
........@.......@............@
......@..........@............
...........@..................
........@..........@...@......
..@@..............@...........
..@.@.........@...........@...
.......@.......@...........@..
.....................@........
.........@@..@@....@@.........
.......@..@.....@........@@...
.............@................
..............................
.@....@.......................
...........................@..
.............................@
.....@.....@@..........@......
...@.......@.........@....@...
........@.....@.....@......@..
