30,30
....@......@..................
@@.@.@......................@.
..............................
....@.............@.....@.....
.....@@@@.........@.........@.
@@.....@................@.....
....@@...@....................
............................@.
..@...@.......@....@..........
..................@.......@...
...........@...............@.@
......@.........@.............
........@@..............@.....
...........................@..
.@@.@.......@......@..........
...@...............@..........
..@.....@....@....@...........
...............@..@........@..
.........................@....
.....................@.@....@.
...........@.....@............
...@.......@..........@@....@.
..@..............@............
@....@........................
.@@...@..........@.@........@.
.......@............@.........
..........@...................
......@......@.@@........@.@..
@.@.@....@.......@............
...@@.........................
