30,30
.......................@@..@..
..............@@..........@...
....@.........................
..............@........@......
@.............@.............@.
........................@.@...
............@@................
...........@..................
.@..........@.@...............
.@...@@..............@@..@....
@....................@......@@
..@...............@...........
@.............@....@.......@@.
@...@..........@@........@....
..............................
.@..@.@..............@..@.....
............@.................
..............................
.....@........@...........@...
....@.@..........@......@.....
....@...................@...@.
..............@............@..
..........@.......@......@...@
...@......@@@...........@.....
@....@..............@...@...@.
..@...@...............@.......
@...........@@..@.............
.....@.@......................
.............@.......@.....@..
...........@@...........@@....
