30,30
..........@......@........@@..
..........@.....@.............
@.............................
@...@..............@..........
..............................
......................@....@.@
......@.................@.@...
....@.....@.@.................
...@..........@...............
......................@@.....@
....@....@...........@.@......
.......@....@...............@.
........................@.....
........@.....................
.........@.@@.....@.......@...
.....@..@.@@@............@....
..........@.....@...@...@.....
.@...@........@@.............@
.@.....................@......
...@.....................@....
....@.........@.@..@..........
......@....................@..
.........@.@.....@.@.....@....
.@............@......@........
@..................@@.......@@
.@@.....@.....@@......@.......
........................@@....
..............................
@...........................@.
.................@@...@@......
