30,30
......................@..@....
@...@..........@@...@.........
.............@@......@.@......
......@.....@.......@.........
...@.@..........@..........@..
@.............................
.@......@......@...@..........
.@......@.....@...@.@..@......
..............@............@..
@@.......@.@...............@..
.....................@@.@.....
...............@........@.....
.@.........@.........@........
..................@....@...@..
.........@............@...@..@
@........@....................
@.@.......@..@.....@....@.....
@......................@..@...
...@..........................
...@................@.........
........@........@..@......@..
@................@............
......@.....@.............@...
.......@....@@................
............................@@
..............@..@......@.....
.....@@....................@..
.............@............@...
..@....@......................
..................@...........
