30,30
.......@....@...@.........@...
.......@.......@.@.......@....
.............@....@......@....
..........@.........@.........
...@......@.......@...@..@@...
.......@...........@.@........
.@@............@..............
..@....@....................@.
........@..........@........@.
..............................
.@@............@..@..@........
.@.............@.@......@.....
........@..@..................
@............@..@......@@..@.@
..........................@...
...@.@......@......@.......@..
..............................
.......................@.....@
........@.......@..@..........
............@............@....
.....@........@.....@........@
@.......@..........@...@...@..
....@..@............@........@
............................@.
.......@...............@...@..
............@...@@...........@
.@......................@.....
@..................@........@.
.@.................@..........
..............................
