30,30
.....@..@.@.....@.......@....@
.@....@..............@........
.........@...............@..@.
.............@@...............
.@....@.......@..@....@@......
....@...........@.........@...
...@..@@@....@........@....@..
.@...................@........
.......@...........@..@.......
....................@......@..
......@.....................@.
@.......@............@.....@..
...@@............@.......@.@..
@.....................@.......
..............................
..@...@...............@.......
................@.@...........
@.@........................@.@
...................@.........@
..........................@...
..@.........................@@
.@........@.......@...........
.......@......@...............
.@............................
@@..........@.................
.....@.....................@..
..........@.@.................
..............@.....@.......@.
............@.@..@........@@..
..........@.@.....@..@........
