30,30
.............@.@...........@..
...................@....@.....
@....@.............@..........
...................@@...@.....
..............@@...@.@@.......
..@.......@.................@.
...@@...@....@@..@............
.......@......@...............
......................@..@.@..
.@..........@.............@...
.............................@
...@@...@.....@....@.........@
...............@.......@@.....
..............................
.....@@........@.......@....@.
.........@.......@......@.....
......@.............@.........
.................@............
..@....@...@@.......@...@....@
...@............@.@...........
.@..@.........................
......................@...@.@.
.................@...........@
..........@...................
......@....@.@...@....@.......
........@.......@..........@..
.......@......@....@..........
.............@.@...........@..
..........@..............@....
..................@.....@.....
