30,30
..............................
....@@.....@......@....@......
.........@...........@........
..............@...............
@.............@...@......@.@..
............@...@....@..@.....
......................@..@@...
.@.......@..........@.........
................@@............
.............@@..@............
.................@............
...@....@...@....@..........@.
........@.....@..@...@........
...............@...@..........
.@...@........@...............
.@........................@...
...............@@.............
.........@@...................
.............@................
...................@..........
......@.....@.......@...@..@..
......@...@..............@....
.......@............@.........
.@..@@@.........@@.....@......
...............@...@.......@..
@......@.............@.....@..
.........@..@..@....@....@@...
..........@@.......@.........@
.......@.@................@...
..............@....@..........
