30,30
.....@.....@..................
.@..@.@@.....@................
.......@......................
..@.@.@@........@........@....
........@...........@.........
....@....@@...............@...
........@@.@..................
...@..............@....@.@....
........@..................@..
..........@...................
.........@@...@...@....@......
..........@...@...............
...@....................@.....
...@.......@..................
....................@...@.@.@.
@..@.....@....@......@........
@.....@....@..@.........@..@..
....@.......@@@.@............@
.......................@...@..
........@.......@.............
........................@@....
..............@...............
@..@..........................
..............................
....@.@.@.@..@.............@..
....@.........................
...........@.@...@......@.....
........@..............@......
..........@.......@...........
.@.@..@..............@........
