30,30
....@...@..................@..
...@..@...@...................
..@..................@........
..@...........................
..........@..@............@...
...........................@..
...........@.....@...@........
..............................
@........................@....
...@.@.....@..........@.......
.......@..........@........@..
...@.@........................
.......................@....@.
@@.....@....@.......@....@.@..
......@.......................
.....@..............@.......@.
....@..@............@.@......@
...........@.@.@.........@....
@.....@........@....@...@.....
.........@....................
..@.................@...@.....
@.......@.@..............@....
............@.........@@.....@
.........@....................
..@....@......@........@...@..
..........................@...
..@.............@.....@@....@.
..@..............@............
...@....@...........@...@..@..
.@@@.........@.@..............
