30,30
@..@..@....@.................@
@.@..@......@............@@...
.......................@......
........@.@@.@.....@.....@....
.....@.............@..........
........@@....................
.@......@..@......@...........
.....@...@.......@............
@.........................@@..
...................@..........
............@@....@...........
...@.....@......@.............
..........@...................
......@...@............@......
..........................@...
..............@..........@@...
.......@......@.....@.......@.
..............................
..@..@..........@........@....
...@.......@..@....@..........
......@..@....................
...@...............@..@.......
..@..........................@
.....@@.......................
@......@.@....@.............@.
............@...@.@...........
........@@.@.@.@..@...........
..@...........@@...@..........
.....@............@...........
.......@................@.....
