30,30
......@.......@.......@...@...
..............@....@..@.......
..............@..@..........@.
.........@.@.........@...@....
..........@..@................
................@.......@..@..
......@..@...........@.@......
.....@...................@....
.....@.......@......@.........
............@..@........@.....
......@......@.@......@.......
...................@....@...@.
@.@.@....@....................
...........@................@@
..........@...................
.....................@.......@
......@@......................
.......@.............@..@.....
.@............................
..............................
.................@............
@..@......@@..................
@.....@..@...@@.............@.
......@..@....................
......@.........@..@@@........
........@..................@..
.@......@@....@....@....@@....
...@..........@..............@
...........@....@.....@..@..@.
....@.........................
