30,30
.....@..........@@............
........@...............@.....
........@.............@....@..
...@........@@................
............................@.
@....@..@...............@.....
........@.@........@..........
..@.....@@......@..@..........
..............................
...@.........@................
.............@...@.....@...@@.
.............@................
...........@..................
.@....@...@...@........@......
.....@.......@@...........@...
....@.@.......@..@@...........
........@..........@..@.......
.....................@........
....@..........@.@.@..........
....@.............@...........
......@.........@....@...@....
.....@...@.............@......
.......@......................
......@@.........@..@.........
..@.........@....@.@.@........
.......@.....@...............@
@.....@......@.@..............
...............@....@.........
@....@..............@..@.@....
..@...........@...............
