30,30
..@...@.@....@..@.......@.....
........@@.........@.........@
....@...@....................@
.........@...............@....
.@@............@...........@..
......@........@..@.@........@
.............................@
..@....@@......@.........@.@..
...........@...........@......
........@.....................
@....@...@......@.............
..@........@..................
...............@..............
.@......@.@@.....@........@...
.@............@............@..
.@.....@..................@...
.@...............@.@..........
.......@...........@..........
...................@....@..@..
.......@.........@..@.........
......@.......@..........@....
.@@........@....@.............
...@@........................@
.@............................
.............@.@..............
....................@.........
@.............................
.................@..@.........
................@........@....
....@.@.@...@.........@....@@.
