30,30
.....................@.@.@...@
@.......@........@............
........@.@..@................
@.......@........@............
..@....@..@...................
.....@.@..............@.@@....
.................@.....@@@....
..............@...@...@.......
...........................@..
..@..@...........@............
............@....@............
.........@@.......@......@..@.
.@.......................@....
.@........................@...
....@...........@............@
@.....@.@..............@......
@..........@....@.@...........
...............@..............
.......@......................
........@...................@.
...@.@@....@...@@..........@..
.............................@
.......@.....@.@........@.....
...............@..@.......@...
.........@....@...............
................@.......@.....
...@......@..........@........
.....@..@.......@.....@..@....
...@....@..@..................
...........@.................@
