30,30
....@...@....@@.......@...@.@.
...@....@...........@.........
............@@.....@..........
.........@..@.................
.....................@........
..............@.........@.....
.................@.......@....
..@........................@..
.........@@@...........@@.@.@.
.........@.@.....@......@.....
...@@@..................@.....
@..............@..............
....@......@.@@..@............
....@.......@..@..............
..............................
....................@.........
............@@.........@......
........@...............@.....
..@@........@...@.............
...@..@.......................
...@.......@...@......@...@...
..@.@..............@...@.....@
........@..................@..
...@....@................@..@.
...@..@...................@..@
...............@.............@
...@.....@...........@........
.........................@....
....@....@..........@@........
................@.............
