30,30
.@....@.....@.................
..................@...........
.......@......................
......................@.....@.
@..@@....................@....
.........@.@....@.@@..........
...............@...........@..
............@@..........@.....
.........@.....@.......@......
.@.....@.....@.....@....@.....
@...................@.........
.....@.....@.......@..........
.....@..............@@........
..................@...........
....@...@......@.............@
.........@..............@@@...
................@@.........@..
........@............@........
....@...............@.........
....@.......@..@..............
..................@...........
.....@.....................@..
.@...@...@@.@............@..@.
...@.@...@..@......@@......@..
..@..@................@.......
@...............@.............
.....@....@..@@..@..........@.
..@..@........@.........@.....
.............@......@.........
..............................
