30,30
............@.@...............
@..............@.@.........@..
.....................@.......@
@......@..................@...
......................@...@...
....@...@..@..................
............@.................
......@......................@
.............@@.....@.........
....@..@.....@...@@.....@.....
..........@...........@.......
.............@................
...@@@...@@...................
............@.........@.......
.........@........@..@.@......
.....@.....................@..
..............................
.........................@....
..........@.....@...........@.
.................@.@......@...
........@...@.....@.@@........
......@.......@...........@@..
.....@.................@@.....
......@..........@.......@....
.......@........@..@.@@.......
.........@.............@....@.
@@.......@.........@..........
..@@.@...............@....@...
........@.@...............@.@.
......@......@..@.............
