30,30
...@................@.........
...@...@..............@.@.....
...................@.@........
...@...........@.........@....
..................@........@..
........@.....................
.............@................
.....@...@............@......@
......@.............@..@@.....
................@...@...@...@.
....@....@............@.@.....
.....@...@..........@.........
@..@..........@...............
...........@@...........@.@...
.@..............@........@....
.@..........@...@....@...@....
....@........@................
...@.......................@..
.........@...@..............@.
.....................@@.@@....
.....@.......@....@...........
..................@.........@.
@....@..........@.......@...@.
..................@.....@.....
...........@.....@......@@....
............................@.
.@....@.@.@..@................
......@.......................
....................@..@..@...
..............@...@.@....@....
