30,30
.@........@.....@..@.....@....
....@@..@....................@
@..@............@.............
....@@............@.....@.....
..@.................@.....@...
...............@........@.....
..............@...@..........@
@.......@.............@..@....
....@....@.....@....@.......@.
.............@..@......@.@..@.
...............@..............
.....................@........
..............................
............@.@...........@.@.
.............@........@......@
.@..........................@.
....@...@...@.@.........@.....
.@.....@......................
@..........@..@........@...@..
......@.........@.@.....@.....
..@.....@...@....@..........@.
...........@..............@...
....................@@.....@..
......@...............@..@....
..............................
........@@....................
@..@......@@..................
..............@...............
.........@..@....@............
.......@.................@....
