30,30
..........@...................
@.@.....@..........@..........
....@.@......@................
....@.@...@....@@.............
...@..........@.@........@.@..
.......@...@.@....@...@..@.@..
@..@.....@.......@....@.....@@
..............................
...@.................@..@.....
...@.......@........@.........
.....@.......@..........@.....
..............................
.@.@@........................@
..........@.@.@..@@...........
....@...............@.........
..@....@................@.....
...@..........................
.@....@@@.....................
........@.@.......@...........
............@.................
.....@..........@.............
...................@@@........
.@..@..................@@.....
..........@..........@........
@.........................@...
.@................@@..........
..................@.@.....@...
..........@.............@.....
.................@..........@.
.@..........@......@..........
