30,30
.@........@@...@....@.........
..@......@....................
........................@.....
............................@@
...@...@..........@.......@...
.......@....@..........@..@...
@...........@......@..........
...@.@.............@....@.....
.@..............@.............
.....@.......................@
....@........@................
................@.......@.@..@
..............@@........@.....
...........@................@.
@.......@.........@....@...@..
.@........@.@.@.....@.........
..........@...................
..................@.......@...
..@..........@................
..........@...................
.@....@.....@.........@.......
.....@....................@..@
.....@@.@.....@...@......@@..@
.@......@.....................
..........@..@............@...
@..@@......@.................@
......@.......................
.....@.......@......@......@..
...............@...........@..
.................@.........@..
