30,30
.@......@..@.@....@......@...@
....@..............@.@@.......
....@...@.....................
..............................
....@.......@...@.............
....@....................@@...
.........@.....@.@............
..........@...................
@.@..........@...@............
..................@...........
...........@...@.......@......
...@@@....@..................@
.@........@...@...............
.@....@@...@.@.......@......@.
.@.@..@....@@........@........
..............@...@@.........@
....@.@@..........@...........
@........@....................
...........@..@..............@
.........@@.......@....@......
.....@..@...............@.....
.....................@........
................@....@...@....
@.@........@................@.
.@..............@.............
...........@.@................
.............@.@.@..@.........
..............................
.............@.........@......
..............................
