30,30
..@......................@....
........@............@........
..@@.@.........@@.........@...
.@.......@....................
...@..............@..@........
........@.......@.@@.......@.@
...............@..............
...............@..@.....@.....
...@......@......@......@.@...
..@.....@..@.@.....@.@......@.
..............................
.@..@........@.......@........
.......@@..@@............@....
..............................
........@..........@.@....@...
..@...........................
.......@..........@...........
.....@...@.@.@..........@.@...
.......@........@.............
.......@..@.........@.........
.@.......@..............@.....
...............@.......@......
......@......@.......@........
.@................@....@......
....@.@..........@...........@
.@............................
..............................
...@.@.@.@...@...............@
.@...@..........@....@........
..............................
