30,30
.@...............@............
........@.@..@........@.....@.
.............@................
...@.............@.......@....
............@...............@.
...@..........................
....@@...@@...@............@..
.....@...................@@...
......@....@.......@.....@.@..
..@.@...........@...@.........
..............@......@...@....
.......................@@...@.
@@......................@.@...
..@@...........@@.............
...............@..............
...@.............@......@.....
......@..........@............
.@......@...........@.........
................@@.@@.........
.........@......@...........@.
.................@....@....@..
...........@.......@..@.......
.......@..........@...........
...@..................@@.@..@.
..............................
..........@...................
..................@.........@.
..........@........@...@.@@...
..@...@...............@.....@.
...@............@............@
