30,30
......................@.......
...@..............@@..@.......
...@..@@............@.........
...@...........@..@.........@.
.....@..............@.@.......
......@...................@...
.@....@..@...@................
.........@.@................@.
......................@...@...
.......@.......@.@......@....@
.......@.....@.....@.....@....
............@.................
..@..@.....................@..
...@..........................
............@............@....
..@..@......................@.
...@.........@................
..@.......................@...
..........@.......@.....@@@...
........................@...@.
..@......@@.................@.
.@........................@...
....................@.......@.
..@....................@.....@
@...................@@.......@
...........@..@@.........@....
..@@...@..........@....@......
............@.@....@...@...@..
.................@.........@..
.......@...........@..........
