30,30
@@.......@....................
.....@.........@........@.....
..........@...........@.....@.
......@.....@.......@..@......
....@.@............@..........
..............................
................@.........@...
.@......................@.....
............................@@
.....@...........@............
..@.@.........@...............
........@......@.....@.....@@.
...................@@..@......
.....................@@....@..
...........@...........@@.....
....@.....@...@...............
...@........................@.
@..@@.........@.....@.........
.....@......@@.....@..@.......
@....@@.......................
...@....@.@.@....@@......@....
......................@....@..
..............@....@..........
............@.........@@......
.@...............@......@.....
..............@.@.@@..........
.........@....................
................@..@.@........
..............@.@.............
..........@@@...@.............
