30,30
...........@@......@@.........
...@..@...@....@....@.........
.@....@..........@..@.........
.....@........................
...............@..............
.@@.@.........................
.@..........@.@.............@.
@...@.............@..........@
.....@....@.......@@..........
.......@.@...@............@...
.............@...@........@.@.
..........@....@..@...@....@..
.....................@.....@@.
..@..........@...........@....
............@...........@.@...
......@...................@...
.....................@........
.....@........................
....@...............@.........
.....................@@.......
@..@.@@............@...@......
..........@......@@...........
.................@........@...
.........@..........@..@...@..
..@.@......................@..
......@..............@...@....
.........@@.........@.........
......@.....@.........@..@....
@.........................@...
..............................
