30,30
............@.....@@..........
....@...........@...@.........
.......@.@..@................@
.@............@...............
..@....................@......
..@.....@@.......@@.......@...
......@..@..............@.....
....@.@.@...@..@.........@....
.@................@.@.........
@@............@.@.....@...@.@.
....@.........................
....@.........................
.............@................
.............@.......@........
@.........@........@.......@..
......................@.@.....
..............@....@..........
.....@.........@.........@....
.............@....@...........
..............................
..............@....@.@.......@
..............................
.................@....@....@..
....@@.........@@.......@.....
.......@......@....@@.........
.......@....@..@@.............
..@....@..@........@.@.....@..
...............@.@...........@
.............@................
.@......@@....................
