30,30
.....@...........@.....@@..@..
...@.......@...........@......
........@.@.....@.....@.......
.......@....@.................
.....................@...@....
..............................
...............@.......@......
...@..............@...........
...........@................@@
...............@...@....@.....
..@..........@.......@.@@...@.
..............@..@...@........
..@...............@...........
........@........@..@.......@.
.....................@........
........@.........@...........
......@.....................@.
....@...............@@.@.@....
@.....@....@...............@..
..........@...................
......................@...@...
...@.........@@......@.@......
.........@..@@.....@..........
.....@.@.......@.@...@@......@
..........@............@......
........@.......@..@........@.
....@...........@...........@.
.@............................
...@...@.......@....@.........
......@.......@...............
