30,30
.................@......@.....
..............................
.@.............@......@..@....
..............@...............
...................@.........@
..@.@...................@.....
@....@.....@..@.......@.@.....
@..............@..............
....@.......@...@.............
.@....@....@..........@..@....
.@......@........@.....@......
.@@.@@....@............@......
.......@........@.........@...
.......@.......@...@..@.......
..@@@.........................
..@.......@.@....@....@.......
..........@......@..@.........
....................@.........
....@...........@........@....
...@................@@......@.
.....@.......@.........@......
.@.....@....@.................
........@.........@..@.@......
................@.............
.............@...@.@....@.....
.....@.....@............@.....
........................@....@
........@@......@.............
....@.........................
............@...........@.....
