30,30
.................@..@.@......@
......@...@.@@..........@.....
...@@..........@...........@..
@...............@.............
@@.....@...@.........@........
.........@....................
..............@...............
..............................
......@......................@
.......................@.@....
@.@.......@............@.....@
...................@..@.......
..@...@...................@...
@..................@..........
............@@...............@
..@............@.........@@..@
.....@...........@@...........
....@.@..............@..@.....
..@.........@................@
..@...........@...............
.......@........@........@@@..
........................@.....
...........@....@@........@...
..@............@@....@......@.
.@.....@......@..............@
............@......@..@.......
.......@@.........@........@.@
@..........................@..
..........@................@..
.....................@........
