30,30
@.@.......@................@..
................@.@..@...@....
...........@...@..@@..@..@....
......@.......@.@...@.....@...
.......@...........@..........
.......@......................
...................@..........
...@..........................
...........@.................@
...@............@@............
....@.....@.@........@.......@
............@.................
............@..........@....@.
.........@...@............@...
....@...@.............@.......
.......@..@..........@..@.....
..@.........@..............@..
...@............@.............
@......................@......
.@.@..@..........@..@..@....@.
...@..@.....@.................
......................@.......
...........@..@.@..@........@.
.@............@...............
.............................@
........@..@.....@............
.@...@........................
@..........@..................
@...@..@...............@.@....
.................@.....@..@@..
