30,30
....@.....@..@.......@....@...
......@...@...................
......................@.......
........@........@@......@....
.............@@...............
.@.....@.@....................
........................@.....
................@.............
........@.....................
..............................
@...@...@................@....
....@..@........@.............
........@.............@.......
....@..........@.........@....
@.......................@.....
..............@..@.@..........
...@.@...@....@@....@...@.....
..........@@@........@.......@
..............................
..@......@.....@..............
@@........@...................
.@...........@..@....@.....@..
.....................@.@......
..@@...........@....@.........
....@..@.@....@.......@.......
......@.............@.....@...
...@......@...................
.@..............@@.......@..@.
...@@@................@.......
.........@....@@...@....@.....
