30,30
@......................@......
...@..........................
.................@.......@..@.
..@.............@..@..........
......@......@.......@...@....
...@..........................
....@....@...@.@..............
..@@......@.....@............@
......@.......................
.......@...@....@..@.....@....
.......@...........@@.........
....@.........@.....@.........
.@..@....@..........@.........
.@......................@.....
............................@.
.@.......@.@....@........@...@
....@......@..................
...@......@.@........@..@.....
.................@..@....@...@
@......@...@@.........@.......
....@.............@...@.......
........@.........@......@....
..................@...........
...............@.......@@.....
....@@...........@......@...@.
....@.........@.@.............
...........@......@...........
@.............@...............
.......@..............@@......
...................@..........
