30,30
............@..@.........@..@.
..@.@........@................
....@@.....@.@..............@.
.....@..............@.........
.......@...................@..
...........................@..
...................@.........@
.............@...@...@........
..........................@...
...............@.........@....
...@.......@...............@..
....@............@...@..@.....
.....@.@.@..@......@......@.@.
...............@......@......@
.....@........................
.@......@....@.@.@.....@......
.........@.@............@.....
......@.........@@............
@.@....................@......
....@........@................
..@.................@.....@...
...@.......@@.................
.......@....................@.
.....@.....@...@..............
................@..@......@.@@
......@...@...@....@..........
.......@.........@...........@
.......@....@.........@....@..
............................@.
........@..@..................
