30,30
.............@................
....@.......@.......@.........
@.@................@..........
...@@...............@..@@.....
@....@.....@.......@...@...@@.
@..............@..............
...@....@@....@.........@..@..
.@....@............@@.........
@.........@.......@...........
..............................
..............................
.@.........@......@........@..
.............@...@......@.....
...@............@....@........
.............@................
.....................@........
........@...........@@.....@..
@......@.@....@............@..
....@@..............@......@..
.............................@
......@...@...@...............
.............@@....@...@@.....
@....@......@.@.............@.
@...........@.................
....@@....@...................
.@......@....@................
..............................
.....@..............@.........
....@@.@...........@..........
..@...........@@..............
