30,30
..................@@....@...@.
..@.@.........................
...@..............@@..........
@.........@.......@.@.....@@@.
...............@.@......@.....
........@.@....@.............@
..@........................@..
.......@......................
................@............@
..........................@..@
...@..@.......................
.@..@@....@@.............@....
...@@@......@...........@.....
................@...........@.
..@.....................@....@
.............@.@..............
...@..........................
.................@.@......@@..
........@..@...@.........@....
@..@...............@.@........
...@..@...@...@...............
.@.........@@.@.@............@
..@........@..................
.........@....................
.....................@........
.........................@....
...........@......@...........
@......@.......@...........@@.
...........@...............@.@
........@.........@...........
