30,30
................@.............
....@......@..................
....@.........................
..@.......................@..@
.@......................@.....
.@@.......@....@...@......@.@.
....@.@......@...@............
..............................
........@....@...@...@@...@@..
.............@@...............
....@..@..@...........@@..@...
@.....@..@...@@...............
@.............................
.....@......@...............@.
.......@@.................@@..
........@.....................
...@...@.............@.@......
.......@..........@.....@...@.
.................@.@......@...
...@.@..........@.............
......@............@..........
@....@...........@............
....@@........................
............@.....@......@....
.............@.@...........@..
..............................
...................@...@..@..@
..@@..@.......................
..........................@...
@.....@.@.......@.@.......@...
