30,30
.......@........@..@...@.@...@
............................@.
.........................@....
....@..........@..............
@........@................@...
.........@@..@.@.........@@...
@..............@...@.@....@.@.
..@...........................
.................@........@...
....@.......@..@.@@.@..@......
...@.....................@...@
.....@......................@.
.@@.............@.............
..@...........@..........@....
..@.............@............@
..............................
...........@...@..............
.....................@........
..@..@.@..........@........@..
.@....@....@..................
............@....@............
.........@......@........@..@.
.............................@
......................@.@.....
.......@.@....@.....@......@@.
@.....@...........@.@.........
.@@...............@.....@.....
............@@...............@
.......@.................@....
..@......................@....
