30,30
...................@..@.....@.
........................@.@...
......@..@.....@.@............
......@........@...@.........@
..............................
....@.........................
..@..@@..@.........@..........
......@..........@..@.........
.......................@......
@...@.....@...................
.@..@......@....@.....@.......
.......@....@.........@.......
@....@......@......@....@.....
................@..@..........
........................@.....
.@..........................@@
.......@...................@..
..................@........@..
@..........@..................
..@..@.@@...@@................
..............................
.....@......@........@........
......@......@@...............
.....@@........@@....@...@.@..
..@..@@...@.@.@..@..........@@
..........@.................@.
..............................
....@..........@..........@...
............@.................
@............@..@...@......@..
