30,30
..............................
..........@...................
...............@..............
...@....@.@@..................
.........@............@.......
............@...@.@@..........
..............@@......@...@...
.....@......@@...............@
........@............@........
.@..@........@.......@@....@..
@.............@.............@.
............@...@..@.....@....
........@.@@..................
.......@...........@@.........
.......@......................
............................@.
..@.........@.@........@.....@
................@@.@......@...
..................@@.@........
............@.................
@.@.....@..@..@..@........@...
...@@..@...@.................@
..@..........@@......@........
.......@.@............@.......
..............................
.....@............@..@........
.@.......@.......@.....@......
..............@.....@.........
...............@..@...........
.....@.........@.@........@...
