30,30
....@........@.....@..........
..............................
........................@....@
.@@.......@.@..@......@....@@.
.....@.......@...@.....@......
.@...@........................
@.@..............@............
......@@...@.@...@............
.........................@....
..........................@...
@..........................@..
..............................
........................@.....
.@.....@......@..........@....
............@@.....@..........
..@....@.@....................
.@......@..@.......@@.........
....................@...@.....
................@..........@..
..@.........@...@..........@..
...............@....@@.......@
....@................@@...@..@
...@........@.................
.....@..@.....................
..@.........@.....@......@....
...@....@...@.................
@......@...@........@.......@.
.@.................@.@.@...@..
.......@.........@......@.....
.@......@.....................
