30,30
......................@.......
............@...@.............
.........@.@..................
.@............................
@......@.@..........@@........
.@.....@.............@@.......
...........................@..
.......@........@......@.@....
...@......@...................
.....@......@.....@...........
.@........@..@........@.......
................@.............
................@.@.......@.@.
..................@....@.@....
...@..............@@.........@
...................@..@...@@@.
............................@.
@@........@@.........@@.....@.
@......@.......@.........@....
..@@..........@...............
............@@@.......@.......
.........@....................
@.........@.......@...........
...........@..........@....@..
@@......@.........@...........
@..............@..@....@......
..@@..........................
.........@.........@...@......
@...........................@.
...........@.............@...@
