30,30
...@....@...........@.....@...
............@............@....
...@.................@..@..@..
.@.......@.@......@..........@
.........@.@...@..............
..............................
....@.........@..@..........@@
................@....@........
......@.....@@...........@....
..............@.......@@......
....@.............@...........
.....@.@...............@......
..@.......................@@..
.....@........................
..............................
@.....@......@...@@...@@......
..............................
......@.......@..........@....
..............................
.@@....@......@...............
..@........@...........@......
...@.....@.................@@.
..............................
.........@..@..............@@.
........@....@..........@....@
....@.........@........@...@..
......@.....@.@...............
...@...........@.........@...@
......@....@@......@....@.....
@............@@...........@...
