30,30
..................@@.@.@.@....
..@@........................@@
....@.....@.@.....@.....@.....
....@..............@........@.
...................@.@........
..@...@....@........@@......@.
......................@@.....@
.....@......@.......@.........
....................@....@....
.............@................
@.....@.......@.@..........@.@
...@..........................
........@.......@.........@...
.........@...@..............@.
........@.......@...........@.
@@.....@.................@....
...........@.......@.@........
...@................@...@.....
..................@@.......@..
.............@..........@.....
..............................
.............@..........@@....
@@...@.@.....@@...............
.........@....................
...@.............@......@.....
...........@...............@..
........@...@@...@............
.@@...........................
.................@@@..........
.......@......................
