30,30
..@.........@.............@...
.......@......................
...........@..@......@........
...@@...........@.@...........
..@...........................
......................@.....@.
...@.@..@............@@...@...
...........@.@...............@
..........@.......@...@.......
...@........@..........@......
....@@.@......@..........@....
@............@@.@.............
.....@........................
............@.................
........@.......@...@.@@.@....
........@......@..............
........@.@...................
..@......@....@...............
.@..............@...@.......@.
@......@.@.@......@...........
@...........@.................
.............................@
....@...................@@....
........@@@..................@
.......@..@..............@....
@.......@............@..@.....
..........@.......@......@....
..............................
..................@@.......@..
....@.........@.@......@....@.
