30,30
........@............@.@.@....
.........................@....
.......@.......@............@.
..........@....@@.............
.@...@@..............@........
.....@..............@..@......
.........@@@..........@.......
.............@......@.........
.......@.............@......@.
..@...@.........@.............
...........................@..
.@............................
...@..........................
.......@...................@..
..........@@.................@
..@@..@....@...@.....@@.......
....@...@...................@.
..@............@.......@...@..
.@@...............@.......@...
............@@................
......................@.@.....
..........@.............@...@.
.............@................
..................@...........
@.....................@.......
..@.........@......@..........
.@....@.@...@@..@@........@...
@.....@.....@.....@......@....
..........@..@......@..@@.....
................@....@........
