30,30
...@..........................
@...................@.@.....@.
......@.@...@.@.........@@....
@................@@...........
.............@......@.........
.@..@....................@....
...................@@.........
......@...........@.....@.....
..............................
....@.......@................@
..............................
..............@..@.@..@.......
.................@@.......@...
....@.@...@...............@...
..@...@....@.................@
......@...@...................
.................@............
......@...@.@.................
@..............@.........@....
..@...............@...........
...@....@.........@....@..@..@
.@....@...........@........@..
......@@........@....@........
@.....@..........@............
.......................@@....@
......@@..@.......@...........
........@.....................
......@....@.................@
@.......@...............@@....
.........@.....@@......@.....@
