30,30
........@.@.@.@...............
.@...@........@...............
...@............@.............
.......@......................
................@......@.....@
.@...@..@@....................
................@...@......@..
.@....@.@.@............@..@...
......@..............@........
@...........@..@........@.....
......................@.......
..@........................@..
@.........@............@...@..
@..........@....@......@......
@..@................@.........
............@.............@...
.@.............@.@.@..........
..........@...................
.........@......@............@
......@.......................
...@..@....@.@................
............................@.
.@............................
.@........@........@@..@......
@......@................@.....
...................@.@...@....
..........@.............@..@..
.......@@.....@..@@...........
.......@.............@@.@.....
...@..........@........@.....@
