30,30
.................@...@........
@..@.....@..@............@..@.
...........@.....@.......@....
..@.................@....@....
...............@..............
........@@....................
....@........@.......@........
......................@.......
....@............@...........@
.@...........................@
..@...........................
............@......@..@.......
..............................
..@.@.@@.....@..............@.
@...@@......@.@...............
.........@@..........@........
.........@...............@....
........@.....@.............@@
.@@@....@.......@......@......
....@.........................
............@..............@..
.@@....@@@...@....@...........
.....@.@....................@.
....................@.........
.@..........@@........@.......
.@@@...@...................@..
.......@...@....@.............
......................@@......
.........................@....
.@@....@...@....@.............
