30,30
.....@..@......@@............@
..@.....@...@.........@.......
@.......@......@..............
............@.................
.......@......................
...........................@..
......@.....@.....@...........
.@................@.......@.@.
........@..........@....@@....
.....@.@............@.........
.@...........@..@.@.@.........
@....@................@.....@.
..@.....@@...................@
@......@.....................@
..@...@...@.@.................
........@..@.............@.@..
...................@....@.....
..............@..........@....
@.....@...........@...........
..........@...@...............
@.......@....@..@..........@..
...........@.......@...@...@..
...........@..................
.............@@.........@.....
@......@......@..........@@...
.........@.....@.......@......
..@...........................
......................@@@.....
..............................
.................@......@....@
