30,30
..@....................@......
...@.....@.................@..
......@.....@.......@.....@...
...@...@......................
...@................@.........
.............@................
.@...@...............@...@....
..........@..@....@...........
............................@.
@..............@.@......@.....
@...@....@....@.......@.......
..............................
......@....@........@......@..
...........@..............@@..
...........@..........@.......
..@@..........................
............................@.
.....@...@@..................@
...............@...@........@.
.@.....@.............@........
....@..........@...........@..
..........@..@........@@.....@
.........@.@.......@....@@...@
@..........@......@.........@@
@@......@....@................
...........................@..
..............@.@....@........
...@...@.............@........
.....@.......@.@..............
..........@@...@............@.
