30,30
.@..@.@.......................
..@......@.........@......@.@.
.....@.............@.........@
..............................
........................@.....
......@................@......
..........@...................
...........@..............@..@
.............@................
.........@.................@..
............@................@
....@.@.................@.@...
............@.......@.........
.......@..@......@...@@.....@.
.....@............@........@.@
......@.......................
...@@...............@.........
.....@......@....@..@.........
...@...@....@.....@...........
.................@............
.@............@...@........@..
................@@......@.@.@.
.......@.........@....@..@...@
............@.................
...@..@.@.....@..@..........@.
.@......@.@@............@....@
.......@..................@...
............@...@.............
@......@.......@..............
@...@.........@..........@....
