30,30
......@@..................@@.@
...........@............@.@...
...................@..........
.........@..........@.........
@..@..........@...............
..............................
....@@.....@...........@......
.@...........@.@......@.......
.......................@@.....
........@.@............@......
..........@............@@.....
..@.....@.....................
........@................@....
.................@............
.....@............@......@.@..
...........................@..
......................@.......
.@........@...@........@.@..@.
........@....@......@@.@......
.@.@@....@......@.....@.......
...@..............@...........
........@......@...@........@.
.......@.@........@...........
....@...........@..@.......@..
..............@.........@....@
.................@............
................@..@..........
..@......@...@.@..............
......@...@....@..@...........
..@.....@..........@.@......@.
