30,30
......................@.......
...@.............@..@..@.@....
........@..........@..........
.....@.........@...@..........
@.......@.......@.@...........
..............................
.........@@..@................
........@.....................
.....................@........
..............@.....@@.@.@.@..
.........@................@...
.........@......@........@....
@.......@.@............@....@.
..@...........................
..@......@.........@.........@
........@...........@@@....@..
..@.............@.............
...........@..........@.....@.
.............@.......@...@..@.
....@.........@...........@...
@.....@......@.......@........
..............@@.............@
...@..........@..........@....
....@......................@..
............................@.
..@........@.@.......@.......@
..............................
..........@...@.....@......@.@
..@....@..@......@............
.....@.....@.@..........@....@
