30,30
..............................
.......@....@....@............
........@........@........@@..
......@.........@......@......
...........@......@...........
.....@....@......@...@........
@......@.............@........
.............@........@.......
....@.......@.........@.......
@.....................@.@.....
.............@@.........@.....
.@................@.........@.
@....@....@..@................
@...........@@..@.............
@..............@.@.....@......
......@............@.....@..@.
@......@..@......@@@@...@.@...
.......................@...@..
.........................@....
..............................
........@...@..@@@..@...@.....
............@........@@.......
........@@.....@@.............
............@.....@.......@...
....@..@.......@............@.
......@...........@...........
..@...........................
@.............@...............
........@.....................
@.......................@.....
