30,30
.....@.......@.@@@..........@.
......@.................@.@...
.......@....@...@.............
...@...........@....@...@.....
@.............@.....@..@@.....
.........@..............@@...@
.@..........@.........@.......
.@.....@......@..........@....
.........@............@@....@.
..............................
.@............................
.......@....@.................
.........@...........@....@...
............@....@@...........
........@.....................
@...@............@@...........
@..@..........................
.......@...@..................
..@..............@............
......@.@...............@.....
..............@...............
..@...........@.............@.
.........@.@....@.....@.@.....
......@..........@............
@....@......@...........@.....
..@..........................@
@..................@..........
...@...........@...@...@@.@...
...@.......@..................
.@.@...@..................@...
