30,30
.....@........@........@@.....
.......................@......
..@.......@...............@...
.........@......@.......@...@.
.......@..........@...........
..@@.......@......@...........
..............................
@............@............@..@
.....@.........@.......@......
.....................@........
....@...@@.......@..@.........
...........................@@.
.@.......@@@......@...@.......
..............@..........@.@..
.......@......................
.............@.@@.@@..........
..........@......@.......@@...
@.....................@.......
......@.........@............@
......@.......................
......@...@....@.......@@.....
........@..@.....@@@..........
................@.............
....@...........@....@........
.............@................
............@.....@..@........
.....@............@@..@.......
............@.........@.......
.......@....@.@...........@...
..@..@.....@.............@....
