30,30
......@...@...................
...@...@..@.............@.@.@.
.@..........................@.
.@................@.....@.....
....................@......@..
@..@.......@...@...@..........
..@@@.........................
......................@.......
.@....@.@.....@.........@....@
..........@..@.....@..........
.@...................@........
...@...........@..............
......................@...@...
@@..@..@.....@...........@....
......@.........@.............
.....@................@.@.@.@.
............@...............@.
.....@.....@....@.............
...@...@......................
@...........@.................
....@.......@.................
..@.....@.....................
......@.....@.................
....................@.@.......
....@.....@..@...@...........@
...@........@@...........@....
........@...................@@
....@....@...............@@...
@...@.........................
...............@..........@@..
