30,30
..@....................@.@....
........@....@...@.@@.@.......
..............................
....................@.........
......@.......@...............
...@...................@......
...@...........@......@.......
.......@...........@@..@......
..@@......@...................
..............................
..@.....@.....................
....@............@.@.........@
...............@@....@...@....
.......@@.....@....@..........
.@.@..........................
@..@........@....@.......@..@.
....@................@..@.....
..@.....@...@............@....
...@.......@....@@.........@..
.@.......@...@...@............
..@.@..............@..........
...........@........@........@
.@.@....................@.@...
...........................@.@
...@..@@......................
...............@..@.....@.....
.....@...................@.@..
@................@.........@..
..............................
....@.@.............@...@.....
