30,30
............@.....@...@.......
.........@...@..@..@......@@..
...@.@..........@.............
.@.........@..@...@...........
......................@.......
.......@.........@.@..@.......
...........@..@..@...........@
....@...@.......@.............
.@..@........@.@......@..@....
.....@.......@...............@
......@....@.............@....
.............@...@............
....@...................@.....
..........@..@.........@....@.
...@.......@..................
...@..........................
..@....@........@........@....
.............................@
@@........................@...
@..................@.......@..
@...@..............@....@..@@.
@...........@.............@...
@...@.........................
@....@@.......@...............
..@.@..@....................@.
..........@.......@.@.........
....@...............@.........
.....................@........
...................@.....@....
.................@............
