30,30
......@.........@..........@..
........@@......@.............
@@....@.....@....@............
....@@........................
....@@..@......@@............@
........@.......@...........@.
..@@.......@@..............@..
..............................
@.@.......@...........@......@
..@.......@..........@........
....@..........@..........@...
.....@@...............@@....@.
..............................
.@.@..................@...@...
...@...........@.....@...@....
...........@.................@
.@.........@...@.@......@.....
.................@......@.....
..........@.......@...........
..............................
.........@...............@....
@.........................@...
...........@.@......@.........
.......@....@...........@...@.
...........@.......@.....@@...
............@....@...@........
................@........@....
............................@.
@................@.@.........@
.....@........@....@..........
