30,30
..............................
@...................@.........
@......@......................
.@@...@..........@....@.......
.@........@....@............@.
.............................@
...@.................@........
..............@.........@..@..
.......................@......
...............@.......@......
.@.......@.@..................
..@........@..@........@......
.....@....@..@..........@.....
...........@@.......@@@..@....
.........@.@..@@..............
.....@.........@..............
.....@.......@......@.@.......
....@......@..................
......@.......................
.................@.....@....@@
...@@.........@...............
@........@..............@.....
@..@.......@..@.......@.......
...........@.......@.@.....@..
.........@@@.....@.....@......
....@......@.@................
......@.@.@.......@.........@.
..............................
............@..@..............
.....@..............@@.@......
