30,30
.......@........@.@.........@.
..............@.@.............
....@.....@...................
................@.......@..@..
........................@.....
........@@@..............@..@.
.@@..@......@.........@@....@@
.................@..@....@...@
......@................@@.....
........................@.....
..........@....@....@.........
...........@..................
....@@....@...................
..............................
.........@...........@..@.....
.........@..@@@............@..
.......@@...@..@...@.@........
..............@..............@
..............................
.........@..@.................
.............@...........@....
..............................
.@.....@....@@..@....@........
.@........@............@......
....@............@....@..@....
.......@.......@.....@........
...@...............@.....@....
...@.......@......@.@.........
..................@...........
................@..@@.@...@..@
