30,30
..........@............@.....@
.............@....@....@......
.....@.@................@.....
...............@...@.........@
..............................
@.........................@..@
....@........@.@.....@..@.....
...................@..........
.......@.@............@.....@.
..@...................@......@
.@....@.......@..@.@......@@..
..................@....@......
..@....@..@...................
..@@....@............@......@.
.@..@...@...............@.....
..................@...@.......
.@......................@@@...
..@....@...................@..
..................@..@........
...............@..............
@..@@......@....@.............
..@.@........................@
..............................
............@............@....
........................@@....
...............@............@.
.........@...@....@....@@.....
.........@...................@
.............@@....@.........@
................@.@.....@@....
