30,30
..........@@.@.....@@.........
........@@...............@....
.......@.......@.............@
...@.......@..........@.......
...........@............@.....
............@............@.@..
...................@..........
..............@...............
..........@.........@...@...@.
....@@..........@..@...@......
.....@........................
..........@@..@....@.....@...@
.@........................@...
...........@@@...............@
...@................@.........
.@..........@.@...............
...................@@..@......
@............@@.......@.......
.@@.............@.............
.....................@......@.
@...............@.............
.........@....................
.@....@......@....@.....@.....
...................@......@...
...................@..........
..@..@@.......................
..........@...@.@....@@.......
.@@.@............@...........@
........@.......@..@..........
@...............@...@.........
