30,30
..@@...........@@......@......
....@....@.......@...@.@......
.....@@..........@............
......@...@......@.....@......
...........@....@.............
..@.......@...@.......@.......
...@.....@..@.................
................@.............
.................@............
@@....@.......@...............
..@...........@...@...@.......
........@..@..................
..@.....@........@........@.@.
.....................@.....@..
.......@..@............@...@..
...........................@..
............@.................
..............@.@@..@..@......
......................@.......
.@......@....@.......@........
.......@..@@...@........@.....
.....@..............@@@.......
.........................@...@
..........@..........@........
.......@..@...........@.......
....@..............@..........
@....................@........
........................@.@...
......@................@....@.
.@......@...@.......@.........
