30,30
.............@.........@......
...@.....@..........@.@.......
..@...........................
...........@.......@..........
........@..@..................
.......@.......@....@.........
................@.@...........
..........@..@........@@......
@...........@@.@.......@......
.......@.....@................
...........@..................
......@.......................
@@......@@....@@..............
..@....@..........@...........
........@.......@@...........@
.@.@......@..@....@...@...@...
..@@.............@...@@..@...@
....@.......@..............@..
.@..@...............@....@....
..@.....@............@..@@....
......@............@..........
.............@...........@....
..........@@..................
...@................@.........
...@.......@............@....@
........@.............@.......
@@........@...................
..............................
..........................@.@@
.......@......@...............
