30,30
.......................@......
......@.........@..@..........
........@.....................
.@....@.........@@..@.....@...
..............@...@...........
............@....@............
....@.........................
....@......................@..
.@.........@.........@....@...
..............@...............
.........@........@...@...@...
..@...........................
@..................@..........
........@@.........@..........
.@..@...............@....@@.@.
.@...........@..........@@....
...@.........@............@...
@...@........@....@..@........
.............@...............@
.@..........@.........@@......
.......@....@@.@..........@...
.................@...........@
.........@....................
.@.....@@.......@.......@...@.
@..@.@.................@...@..
.........@........@....@.....@
...........................@..
.@..........@........@.....@..
..................@.....@.....
.........@....@......@........
