30,30
...................@..@..@....
@..@....@@...........@@.......
.@..@.........................
.....@........................
@.............................
..@..........@........@.....@.
.@@@.@....@@..................
.........@.@.......@..........
....@......@............@.....
.....@.....@..............@...
..@.......@..........@.@......
....@........@.@........@.....
.@.........@..@...............
.@@........@@...@.@...........
......@......@..............@.
.@@.................@........@
..............@.@..@..........
.....................@........
........@.............@.......
......@.......................
........@.....................
@.......................@.....
..@......@.................@..
@....@.@...........@....@@@...
.........@....@...@..........@
.................@............
.@............................
...@.....................@..@.
............@....@............
.......@.............@...@....
