30,30
.......................@.....@
.............@................
..............................
..@.@..@...@.............@...@
..@......@......@.......@.....
............@....@.@..........
.........@........@.........@.
.@........@..............@....
@......@.....................@
........................@.....
..........@..........@..@.....
.....@.......................@
...............@.....@.....@@.
.......@@.........@...........
..@@.@...........@@......@..@.
..@....@......@@..............
..........................@...
@...........................@.
.....@.@..@.....@.......@.....
..............................
.......@.@@......@.@..........
.....@......@..@..............
..........@...@..............@
@.......@.......@..........@.@
.......@@......@@....@.....@..
.........@..............@.....
..........................@.@.
......................@.......
..........@@........@....@...@
........@.....................
