30,30
.....@...............@.@.@....
..............................
.........................@....
...................@....@.@...
.....@................@.....@@
.@.....@....@.............@...
........@..@.....@..@......@..
.....@@...........@...........
.....@.@...............@.....@
....@..@...................@..
.................@............
........@....................@
.@...................@...@....
........@.@..............@..@.
.@@.................@.........
...........@.........@........
.@......@......@.........@....
..............................
........@.........@@..@...@...
.@..@...............@.....@.@.
@.........@..............@....
.........@.................@..
................@.............
.@.@.....@@.....@.@......@..@@
..@........................@@.
.@..@.......@.................
...@......................@...
..............................
.....................@@...@...
....@@.....@...............@..
