30,30
@................@.....@......
...............@.....@..@@...@
...........@..................
.......@......................
.........................@..@.
............@.............@...
....@....@...@...............@
............@.........@.......
..............................
.........@.....@..............
..............@.....@...@.....
....@@.@...@...........@@....@
.......................@.....@
...@............@......@......
.@...........@................
...........@....@.@...@....@..
.......@@........@..@.......@.
................@.....@...@...
.......................@....@.
.@............................
.@..@.......@.@....@.........@
.....@..........@..@....@@.@..
........@.......@............@
....@.......@.................
........................@.@.@.
.......@.....@..............@.
...@....................@..@.@
.@.@.........@...@............
....@.........................
.@......@....@................
