30,30
.....@...@....................
..............................
@.........@...................
..@@@...@@.......@..@.........
........@......@..............
.....@@...............@.......
...........@.@.....@..........
...@.....@...........@...@....
.@........@...................
@......@................@.....
.@....@...@.......@........@..
........................@.....
..........@...@.......@@.....@
@......@........@.........@...
..........................@...
@..................@......@.@.
.......@...@..................
..@......@.................@..
.@..............@.@....@.@....
.............................@
.@...........@@..........@....
.........................@....
.......@..@.@@..............@.
......@.....@......@..@......@
....................@....@....
..........................@.@.
..@......................@....
..............@....@..@.......
.....@...@@................@..
..........@@.@................
