30,30
..@...@...@..@.@..............
...........@................@.
.......@...@.@..@@............
.......@@........@......@.@.@.
...@..........................
......@..............@........
..............................
................@.@@..........
....................@....@....
..@..@.....@@..........@......
.......@......@...............
.@.............@...@@...@.....
......@........@..........@...
...@.......@...@@.....@.......
.........@@...................
@..@.........@........@.......
...@@@....@.@..@.............@
..........@........@..........
......@...@..........@........
.............@................
.....................@...@....
......................@.......
@.............@.....@........@
.@.....@......................
................@...@@........
...............@........@....@
.....................@.....@..
...@..........@....@...@......
@........@.................@..
@.............................
