30,30
............@@...........@.@..
......@......@.....@.......@..
@......@....................@.
..............................
..............@...............
@...........@@................
...@@...@.@..................@
@...........@.................
...@.@@.......................
....@........@................
......@..@...................@
@.............................
...@.....@.....@..............
.......................@.@....
..............@...........@@..
................@........@....
.@................@@....@@....
..............................
.........@@.............@....@
............@.@..............@
......@@...............@......
.................@.......@....
...@.@.............@.@.@.@....
............@....@.....@..@...
........@....@.......@....@...
...............@...@.....@..@.
...@.....@............@.......
.......@....@.................
.........@.........@@.@@..@...
.....@.....................@.@
