30,30
..@........@......@.@.@....@..
.....@......@.................
...@....@...@.................
.....@.@...........@..........
............@.................
...........@...@....@.........
..............@.....@.....@.@.
...@........@..@......@.......
.................@.......@....
.......@..@.........@........@
......@.............@.........
.@.@....................@.....
.....@..@.....................
..@.........@.................
...................@...@......
..........................@...
...........@..............@...
.....@.........@.....@........
..@@@...............@..@@.....
.............@................
...@...@..@...................
.......@..............@@..@...
.......................@..@...
.......@@....@......@........@
..@.................@.......@@
....@......@......@........@..
@..............@..............
....@..........@...........@..
....@@@.......@..............@
...@........@.................
