30,30
....@.........................
.....................@@....@.@
...........@@.........@..@.@..
...@.@.....@......@....@......
.............@.............@.@
.....@..@.....................
@........................@....
................@...@......@..
.@..@................@........
......@.....@..@@.....@.@.....
@..............@..............
...............@@..@.....@@...
...@..........................
.@..@......@...@.@............
............@...@.............
..................@...@.@.....
@@@......................@....
............@.........@.......
....@..........@.@.......@@...
............................@.
.@......@................@....
.......@.................@....
.....................@...@....
.........................@....
..............................
..@@........................@.
........@@..........@.@..@....
........@.......@...@@........
.@.............@..............
..........@@....@.......@.....
