30,30
......@.....@..@....@.........
...........@.@.........@@.....
..................@...........
........@...@.@.............@.
.......@.@........@........@..
...................@.@......@.
.......@.@.......@............
.................@............
.........@....@...........@...
......................@.......
.@....@..@...@................
....@..............@..........
..........@.@..@.....@@.@.....
..............@......@........
........@.....@@..............
..@..@@.....@.@........@..@...
........@.......@.............
.@....@.@..@...........@.@.@@.
..............................
.......................@......
.....@.@.............@........
.......@....@.@...............
................@.............
@.......................@.....
.@......@@....@.......@.......
......@@.............@......@@
.............@.............@..
...@..........@..@............
........@.....................
...................@.@........
