30,30
..@@.......................@..
...........................@@.
..@.........@.....@...........
.........@.......@...@........
..@..@.....................@..
.........@@@......@.........@.
......@...............@.......
..............................
@...@........@...@...@........
@........@............@..@....
..........@..@...........@..@.
.@....@................@......
.@........@...................
.@......@.....................
@.@...@.......................
@..@.@.............@.@........
....@.@.@...........@.........
@............@@........@.@....
............@.................
..............................
...................@@.......@.
....................@.........
..........................@...
....@..........@....@.........
@....@........@....@@.@.....@@
......@.....@......@......@...
..............................
@..@..@................@....@.
.....@......@...........@..@..
.........@...@................
