30,30
........@............@........
@..................@..........
..@...........................
........@@.........@..@..@@...
.@............................
......@.................@.....
............@......@..........
...@........@......@@.........
..@......@.....@...@.........@
..............@.......@.@@....
.@.@.@@.......@...............
....@......................@..
@.............................
......................@.......
@.............................
.............@......@......@..
..............@.............@.
.@......@....@....@.....@.....
.......@@.....@.....@...@..@@.
.........@....@.......@....@..
.......................@....@.
.....@@.......................
...@.......@@.................
....@...@.....@......@........
.................@......@.@...
...@................@.........
....@......................@..
.............@....@@..........
..........@........@......@...
.@...@.@....@@...........@....
