30,30
.....@...........@..@.........
.......@@..............@.....@
......@.......................
..@...........@............@..
...@...........@@.....@..@....
..........................@@..
....@@...@.......@.....@.....@
@.............@.....@.@...@...
.@.....@.....@....@...........
.........@..@.................
...............@..........@...
......@.@@.@...............@..
....@@.......@....@........@..
@.............................
@.......................@.@...
....@.........................
..@.............@....@...@....
.....@@.......@...............
.@........@...................
........................@@....
...........@.@.........@......
...@..@.....@.@..@.....@......
..........................@...
........................@@....
@@...........................@
.............................@
@.............................
.@....................@...@...
.....@..............@@........
.............@..@.@......@....
