30,30
.@...@..@.....................
..........@.....@...@.........
.......@...........@....@.....
...............@...........@..
.....................@........
..@@.......@.......@..@.@.....
..............................
..@......@..........@@.@......
..@.............@....@........
..............................
...@....@...........@.....@...
.@.@......................@...
..............................
...........@......@.@...@.....
....@.....@......@..........@.
...............@..............
......@.@..@.......@..........
@.............................
@...@.................@......@
@@.@.......@................@.
..@...@..@...@.........@......
.@.............@...@..@.......
.............@...@............
....@......@............@..@..
...............@...@@..@......
.............@.@..........@...
......@@..........@...........
.........@............@.......
...@...@............@.......@.
....@@....................@...
