30,30
..............................
..........@.@........@.......@
............@.................
@.....@...@.@..............@@.
................@.............
..@...........@..@......@.....
....@.....................@...
...@....@.....................
........@..@@.........@.......
........@.....................
..........@.@..........@......
....@.........................
...............@.@............
...@.....@...@.........@.....@
..............................
..@................@@.@....@..
........@...@....@............
.....................@..@.....
....@.@.......................
.@...@..@................@..@.
...@@.......@......@...@...@..
................@.............
....................@.........
@@............@...@.....@....@
.......@@.@..@................
.....@@...@........@..........
................@.............
..@@...@@..........@..........
...@@..@@.....................
......@@...........@.@....@...
