30,30
...@..@.....@@......@@........
..@....................@@..@..
.@..........@........@...@....
...............@......@.......
...........@..@......@........
..............................
...@...................@.@..@.
..............................
@.....@......................@
............@....@......@@....
.........@..........@...@...@.
.......@...@...........@....@.
...............@..............
..@.....@.....@......@....@...
..........@.........@.........
.....@........@........@......
.........@....................
..@..........@.......@@...@..@
..@.......@..@......@.@...@@..
........@........@..........@.
.@..............@.............
............................@.
....@...@...........@.........
.@...........@................
..............................
..@..........@..@.........@...
..@@..........@....@..........
.......@.....@................
@..........@..................
..........@@.........@.......@
