30,30
.....................@........
...@@.................@....@..
....@...........@.....@@...@..
..............................
....................@.........
.............@@.@@............
.........@@..................@
.......@.................@....
.@...@.........@@.............
@..@.....@..@........@........
....@.....@@..........@.@.@...
.........................@..@.
....................@.......@.
.........@.................@@.
......@@..@...@....@...@......
...@@......................@@.
.....@........................
...........@......@......@....
.......................@......
....................@.........
.@....@..................@....
..............@.@.......@.@...
......@...................@...
..................@...........
..........@.............@@...@
....@............@..@..@....@.
................@.@..@........
.@..............@..@..........
.............@................
@...@@.@..@.................@.
