30,30
.@............@@......@...@@..
..............................
@............@...@....@.......
......@....................@..
....@...........@......@....@.
...........@...@...@...@......
..@..@.@.......@@..@...@......
............@............@.@..
............@...@......@......
...................@......@...
.................@@.@.....@...
....................@.........
@.......@.....................
..............................
........@...@..........@......
..................@...........
..........................@...
.......@@.............@@...@..
.@......@.@....@.........@....
...........@@........@....@...
.....@............@...........
@@................@......@....
.........@.......@....@.......
.................@..@.........
....@.........................
................@...@@.@......
...@....@...@......@......@.@.
...@..@.....@@................
..@..........................@
.........................@....
