30,30
.........................@....
............@...........@.....
......@..........@............
.....................@..@.....
.......@@.@.@.................
........@...........@.........
..............@..@...@@.@.....
.....@@.........@........@....
....@.@......@................
.......@.....@.@.....@........
...@@...@..........@...@......
..................@........@..
..@......@@...@...@.@......@..
....@..................@......
.............@.........@@...@.
..........................@...
.......@...@...............@..
..@@.......@.@................
.........................@@...
.....@.....@..................
..@.......@.@.................
.............@@........@.....@
..@....@....@@..........@...@.
@.......@.....@......@........
@.............................
....@...........@.............
...@.......@..................
...............@...........@..
........@.....@.............@.
.@.....@......................
