30,30
.........@....................
.........@..........@.........
...........@....@.............
.....................@........
..........@...@.@.....@....@..
.@.....@@...@.@.........@.....
............@..........@......
.@..@........@......@...@.@...
..........@........@..@.......
...@..@.......................
........@.....................
...@....@....@.......@........
.................@...@...@....
....@..............@..........
.....@....@.@.....@.@.........
.@....@@@.......@.............
.@............................
...@............@.......@.....
......@.......@.......@....@..
....@...........@.....@.......
.......@.............@@.......
...@......................@...
.........@....@......@....@...
.............@@@....@.........
..............@@...........@..
..........@.@....@.@..........
........@.....................
....@@......@.................
........@.........@...........
......@...@.....@.............
