30,30
....................@.........
.................@..@.....@.@.
...........@.@..............@.
.@................@...@..@....
@.........@..@..@....@.....@..
..@..............@............
....................@...@.....
..@.@.........@...........@...
.....@........................
...........@.............@....
..............@...........@...
.....@...@........@.@.@..@....
........@................@....
....................@@........
........@...@......@..........
...........@.................@
.................@.@...@..@...
.@@.......@....@...........@..
........................@.....
@.@...@.......................
..............................
.................@........@...
........................@.....
........@..........@.@.......@
@.......@.@@............@.....
............@......@..........
.@.....@@...@..@.........@....
.......@.............@........
...@.........@..@...@...@...@.
..........@.@..@..............
