30,30
...@...........@..............
.@.......@...@...@....@.@.....
..............@.....@...@....@
.............@....@.......@.@.
.@..@...@................@....
.......@........@..........@..
............@@....@...........
..@........@....@......@...@..
..........@....@..............
.@..........@.........@.......
.....@@.@...............@....@
...@..........................
...@..............@.....@.....
.@........@....@.............@
....@..............@......@...
..............................
......@....@........@...@.....
.........@.......@...........@
..@...................@...@...
.............@...@............
.........@..@.......@...@.@...
.......................@.@....
.......@.@....@.@.@...@.......
........@............@........
.......@................@.....
....@.........................
.......@......@...........@...
..............................
...........@.......@..........
.........@@.........@.........
