30,30
.@......@............@........
.......@..@............@.....@
........@.............@@..@...
.........................@....
@............@................
@@.......@................@...
@.@.@....@.......@..@........@
..........@...................
...@.................@......@.
..................@...........
.............@....@.......@..@
...............@..............
.......@.....@................
...............@...@..........
.............@....@....@.@...@
..............................
...@...........@..............
@...............@.........@..@
..........@.@.................
.....@...........@......@....@
.@@..@........@...........@...
...@...........@........@.....
.....@@@.@.@..................
...........@...............@@.
..........@....@..............
.........@....................
....@..@.@....@........@....@.
.......@...............@......
.............@@........@......
.@.....@........@.@...........
