30,30
@.@.@.........@...............
........@......@..............
.........@.....@..@......@....
......@.......................
........@.......@.............
.........@.......@.@..@@......
......@...@@.......@..........
..........................@...
@...@@.....@.....@...@........
..@.......@...................
.......@........@.@.....@....@
...........@..................
..@..........................@
..........@..@........@.......
.....@@....@...@..............
.....@@.......................
.............@................
...................@.......@..
@.................@......@....
.............@.....@....@.....
.....@.....@..................
@.................@..........@
...............@......@.@.....
..@.............@.........@..@
..............................
@..............@............@.
..................@.@....@...@
..@...@....@....@.......@.....
....@..........@..@.@..@.@....
.@............@.......@.......
