30,30
..@..@....................@.@.
@...@...@.....................
.....................@........
....@......@................@.
......@........@...@..........
.......................@......
.@@.....@...@@..@..........@..
@................@..@......@..
.............@................
.....@........@...............
.............................@
...@.@........@.....@....@....
..............................
....@..........@.@.....@......
.........@.............@.....@
..@.@....................@....
....@@.........@.@@...........
..............................
..............@.....@.@.......
.@....@......@.......@........
..........@...................
..@...@......@.@@..@.........@
@@......@.........@...@.......
..........................@...
..............................
.@..@...@.....................
..@.........@..............@..
@...........@......@..........
.@....@.@@...@@....@.......@@.
...............@..............
