30,30
..............@......@..@.....
@.......@.....................
.........@....@..@.........@..
........@@......@.............
..@.@........@..@.............
........@.........@...........
.............................@
@..@................@.........
.........@..@.....@@..........
.........@.@.@................
@.............@........@......
.....@.............@....@..@..
....@.@.......................
.......@....................@.
............@.................
........@.......@.............
.@............@.@..@.....@@@..
@...@.................@...@@..
......@.....................@.
...@..........@.......@.......
..........@..@..@.............
......@...@..........@@.......
.........@...............@....
..............@..@...@........
..............................
.....@.................@......
.@........@@@.....@...........
............@...@.............
..@..@.@.@@...................
.@............@@.......@......
