30,30
@@.........@.......@..........
..@..@..............@.........
..................@..@...@....
...........................@..
..........@...........@@...@.@
......@...................@...
.@........@....@...@.........@
.......@..............@...@...
......@..............@......@.
...@..........................
.............@@@..@........@..
.............@.....@......@...
...............@..............
........@...................@.
.....@........................
..........@.@@.@..........@@..
......@.@......@......@......@
.......@..@@..........@......@
..............................
.........@..@......@..........
.....................@@@@.....
.......@............@.......@.
..@...............@...........
............@.....@.@....@..@.
.....@.....@.........@..@....@
...@...........@..............
..@....@......@.....@.....@...
.@.@..........................
..............................
.@............................
