30,30
....@.............@.@.........
....@.........@...............
....@..@......@.....@.........
....@............@@...@......@
.....@.............@.........@
....@....@..@.................
.......@.................@.@..
@.............................
@.....@@...............@.@....
.........@....@....@......@...
....@..@..............@...@...
.............@......@........@
.@............................
.....@.@......@...............
.....@..@............@@.......
..@.......@.......@@...@@.@.@.
..@@...........@..@.......@..@
.......@.@...........@.......@
........................@@....
......@.........@.............
...@....................@.....
......................@.......
.......@..........@...........
.....@............@.@.........
...@......@.......@....@.....@
......@................@@.....
..............................
.@.....@..............@.......
..............................
.@............................
