30,30
..........@.......@.........@.
.................@.....@......
...........@.........@........
@..............@.........@....
................@...@.@......@
.@..........@..@....@...@.....
@...............@.............
@..@........@...............@.
...................@.@........
............@@................
........@..@.@................
.........@.................@..
.......@.....................@
...@...@.......@..............
..@.......@.........@......@@.
.....@@........@...@..@.......
......@@...............@..@...
@........@.............@....@.
........@..@.........@....@...
..@......@....................
...@.............@..........@@
..@............@.....@........
............@....@........@...
@.........@.............@.....
......@...........@...........
@.....@.........@...........@.
.................@.........@..
......@.@...@....@............
.@............................
........@.....................
