30,30
..@......@...@...@.......@....
...............@..............
..@...........................
..................@......@....
...........@....@..........@..
.......@....................@.
....@.@@.......@..............
.......................@......
........@.....................
..............@...............
......@....@@@@...............
..............................
.....@....@.@....@.......@....
....@.............@...........
..........@@....@.............
.....@.....@......@.........@.
........@..@........@@.@.@....
....@..@...@..................
.@................@.@.........
.........@@.......@...........
.@...........@............@...
....@.................@.@..@@@
.........@.....@..............
..@...................@.@.....
...@...@..@@..................
....@..@..............@@......
..@.@...............@.@..@.@..
...@.....@..........@......@..
..............................
...@..@.........@.............
