30,30
..@.............@.....@.......
...@................@.........
..@...@.........@..........@..
..@.....@......@..@.@@.@......
.@.................@.........@
................@.............
......@...........@...........
.............@....@...........
..........@..@......@..@....@.
...@...@.................@..@.
...@..@..............@@.@.....
..........@.......@..@........
..........@.........@.........
........@.....................
@@......@.....................
.................@.........@@.
.............................@
............@@.........@...@..
@..............@............@.
...@...@.......@...@....@.....
...............@.@.......@....
..................@...........
.....@...@....................
.@.........@.....@..@@.@......
..@....@.........@.@...@......
...@.@.........@.............@
..................@...........
........@...............@.....
............................@.
..........................@..@
