30,30
..................@...........
...........@...@..@.@....@@...
.....................@........
...@..............@...........
............@.................
........@.....@.@..@.@....@@..
.....@.....@.@...@@...@.......
.............@@........@.@....
...................@.........@
.......................@......
............@...........@.....
.................@............
......@.......@....@..........
......@......@.......@........
............................@.
.............@.....@......@...
......@..................@....
@...........@...@......@......
@.....@....@@...........@.....
.@.@....@..............@......
........@..@.....@............
...@....@..@..@............@.@
.......@................@.....
.................@............
............................@@
..@...............@.....@.....
.............@.....@...@@.....
...@@.........................
.................@..@..@......
...........@@........@......@@
