30,30
.............@............@...
..@.@......@.......@..........
....@.........................
.....................@.....@.@
.......@......................
.............@@@....@...@.....
..@...........@...............
.@.............@.@...@...@@..@
............@.................
...@.........@....@.......@.@.
...@....@.....@.....@.@..@.@..
..@.......@...................
.............@..@..........@..
..@.@.....@........@@..@......
.........................@.@.@
................@..@...@......
......................@@......
@..@...@@....@.........@......
..@...............@.....@.....
@...................@..@......
..@@...@.@@...................
.......@.......@..............
............................@.
..........................@..@
..@...............@...........
.........@....................
.....................@.@.@....
.......................@@.....
..........................@@..
..................@...........
