30,30
..............................
@..........@.@......@......@..
................@.............
.@......@........@...@........
....@.....@...@..........@....
@..@...@...........@....@@....
..............@........@......
..............................
.........@...............@....
...................@..........
...........@...........@@.....
.@.@.@.@..........@..@........
........@..@..................
..............................
.........@......@..@....@.....
.................@...@...@....
........................@.....
...@...@.................@@..@
@@....@............@......@..@
.........@...................@
.........@..........@.....@...
....@.@..................@....
.....@..@@.@..................
.....@.@@.....................
...@.@...........@..@.........
...@.@..@.@.@.....@....@......
.............................@
........@...........@..@......
..................@....@.....@
........@..................@..
