30,30
..................@...........
.......@......................
@.....@..@....@@...@@..@.@....
.......@.@.@..................
@.@..@........................
............@...@...........@.
..........@...........@.......
..............................
.@.....................@.@....
......@...@............@......
.......................@..@...
..............@......@........
...@@..@.....@...........@....
..@.........@....@............
.........@...........@@...@...
...............@...........@..
............@@................
..@....@.............@....@...
.................@.........@..
.....@........................
..@..@....@.@.................
.....@........@...@.....@.....
..................@.....@...@.
@..@.........................@
.....@............@......@....
.....@..........@.............
@.....@........@..@.......@...
....................@.........
......@.@.................@.@.
....@..@......@@.....@.@......
