30,30
.......@.............@...@....
.............@...............@
..@@...@@.........@...........
...................@.@.@@....@
.........@....................
@........@..@....@............
.@...@.....@..................
................@@...@..@.....
................@...........@.
.@.......@..@.....@....@......
..@....@............@.........
.....@..................@.....
.....@...@...............@....
...@...@.........@............
........@.......@.............
...................@..........
..........................@...
...........................@..
............@..@@...........@@
..@...........................
...@......@@..@.......@.......
..@....@......................
...........................@..
..............@....@....@.....
...@.@........@@..............
...........@........@.....@.@.
................@@.....@....@.
........@.@...@@...@@.........
........@.....@...............
@@................@...........
