30,30
................@...........@@
.@........@@............@..@..
...@............@.............
...............@...@.@@.......
........@............@......@.
..@...........................
.....@.....................@..
.@............................
......@.@.......@.@...........
.......@.@@..............@....
....@..@.......@..............
......@....................@@.
..................@.@...@....@
...........@...@.......@......
........@......@........@....@
......................@@@.....
..............................
..@.....@................@@...
.............................@
.....................@........
..@..@.@......................
@.....................@.@.....
@.............................
.........@.................@..
..@.........@.....@..@........
....@....@......@.@@..........
@......@.@.@..........@...@...
.............@......@....@....
@@.@......@.............@.....
...........@..........@......@
