30,30
.@............................
..........@@.@...@.@.....@.@..
......@............@..........
......@.......@.@.......@.....
.....@...............@........
..........@..............@..@.
.........@.@...@...@....@@@.@.
...@........................@.
..@.....................@@....
................@........@....
.......................@....@.
...@.................@......@.
.............@@.....@.........
.......................@......
...........@..............@...
...............@..@.....@.....
..........@@..............@@..
...@.@.....@..@........@......
................@.............
..............@...............
...@.......................@.@
..............@............@@@
...........................@..
..............................
..........@@..@.@.....@.@.....
...@......@.......@....@.@....
..............................
@.............@.....@....@....
.@.........@..@......@.....@..
............@..@.@............
