30,30
..@...@...@.......@@..........
............@.....@...........
.......@.....................@
.....@.............@.@.......@
....@..@.......@..........@...
..@............@.............@
.....@...@.......@@...........
...@.........@.........@......
.@........@.........@.........
@.@.......@...................
..@............@......@.......
.......@@.....................
................@.......@.....
@...........................@.
@.....@................@.....@
...@.....@..@........@.......@
........................@.....
...@....@...............@.....
......@.......@............@..
..@@.......@@..............@..
..........@.......@..@........
.@.......@.........@..........
..........@...............@...
...@...........@......@.......
.....................@..@.....
.....@...........@.....@@.....
..............@..@@...........
...........@.....@........@...
.@..@.........@...............
.........................@....
