30,30
.....@........................
......@.@........@....@.......
..........@...................
.....@@.................@.....
....@.@..........@@...........
......................@.....@@
.@....@@.@@.......@..@........
........@...@.................
.....@..........@.............
......@.........@......@..@...
...........@.........@....@...
......@.@..............@......
.......................@.@....
........@......@..............
@......@.......@.......@@.....
..................@...........
...........@..@...............
...@..............@.....@.....
@..@.@....@.........@.........
...@............@.............
.@..@...........@...........@.
..............................
........@.........@.@@........
...@..........................
........@@....................
..........@.......@..@@.......
...@.....................@....
.........@..............@.@@.@
.......@.@@......@........@...
.@...........@....@.......@...
