30,30
..........................@...
....................@...@.....
.........................@..@.
............................@.
......@........@..@.....@.....
..............................
.@...@.@.@....@.........@.....
.....................@........
..........@.....@......@.@@...
@.......@.....@...............
.................@.....@@.....
....@.................@@......
....@........@.....@.......@..
...@........@................@
........@.@........@..........
.......@...@...........@...@..
........@......@@@@....@......
............@..........@......
.......................@@.....
..@@.........@@..........@....
.....@..@.@............@......
.................@............
...@@.......@.@.............@.
.....@.................@......
....@...@.....@....@...@@.....
..........................@...
..........@...........@......@
...@..@..........@...@.......@
.......................@..@@..
..............................
