30,30
..........@....@.@...@......@.
@...@..@.............@.@..@...
.....@....@........@..........
........@@.@................@.
..............................
.............@......@.........
..................@...........
..........@....@..............
....................@.........
.............@.......@..@.....
...........@@.@...........@...
..........................@...
.......................@...@..
@.@...........................
........@@...@..@.........@.@.
......@....@.........@.....@..
....@..@.......@.....@........
..@.....................@.@.@@
....................@...@...@.
@.............................
..............@...........@...
....................@.........
.@...@@...............@.@.....
......................@.......
@@........@............@......
..........@..............@@...
@.@.......@.................@.
.@...@.@@...............@.....
...........@...@.@............
....@.@.........@.............
