30,30
.............@................
.@......@.....................
.@...........@@...............
......@.......................
.@.....@.......@..............
.....@..@..................@..
................@.....@.....@.
.@..@.....@.....@.............
@......@@.@.......@........@..
.......@@@@....@@...@.....@@..
@.............@...@...........
....@.................@.......
@.............................
...@...............@.......@..
.........@....@..@.....@.@....
.....@...........@............
..............@...........@...
..............@...@...........
.........@.@.....@..@.........
............@.......@..@......
@@....@..@........@...........
.........@.........@..........
..........@...................
...@.............@....@.......
..........@......@....@...@..@
.@.................@..........
.........................@..@@
.............@........@.......
..@.....@.....................
@.@.............@.............
