30,30
......@.......................
.........@...@.@..............
..........@................@..
.................@@...........
...........................@..
.....................@........
.........@....................
...@.......@......@.....@....@
@.@......@...@..........@.....
...............@............@.
..@...........................
....@........@@........@......
....@...@@.......@...@.......@
....@..............@.@........
.............................@
.....@...............@....@.@.
..@..@..@..@....@.........@@..
......@....................@..
........@.@........@.....@.@..
......@@......................
.........@....@..........@...@
.....@...@..@..@...@@...@...@.
...........@@.................
.................@............
@...............@.........@..@
....@......@..........@.@.....
......@..@....................
...........@..............@...
.....@.@....@....@............
...........................@..
