30,30
...@..........@.@..@...@......
.......@........@.............
................@.............
...@...........@@..@.@........
..@..@........................
...@......................@...
.@@.@.............@@...@.@....
...............@..............
.......@@...............@.....
@........@.......@.@..........
......@..@..........@.........
............@.................
..@........................@..
.....@@.....@...@@............
...@......@...................
.....@................@.@.....
..@..........@................
.@......@..@.@@..@............
...................@..........
.............................@
.........@.........@..........
@.............................
.....@@...@..@...@.........@..
.....@.@.........@@...........
....@.........................
...............@...@...@......
.................@....@......@
........@..@.@@...@@.@........
...................@.@......@.
.........@....@...............
