30,30
..@...@.......................
..@....@.@....................
....@..@.@..@.................
..@.@...@@..................@.
..@....@@.@....@...@.@....@...
...@.................@........
.........................@...@
.....@.........@..............
..........@.....@.......@..@..
...............@..@@..........
............@.................
.....@................@.......
.@.....@..............@.......
....@.....@@.........@.....@..
....@..@....@.......@.........
........@..@@.@...............
..@............@.............@
..@......@..................@.
................@.............
............................@.
.........@..@............@....
..@.....@@....................
.@..........@...........@....@
..@.........@.........@.......
.....................@.@......
.@.@..........................
.......@.......@..............
.................@......@.....
.......@...@..................
.@..@.......@.@..........@....
