30,30
........@..@...........@@.....
..............@...............
.....@..........@.@.....@..@..
.......@...@...@.@............
..@.......................@.@.
.............@.....@....@.....
...@.@........................
......@..@.@.......@..........
...............@...@.........@
..............@...@...........
.....@.@.@.@........@@.@......
@..........@..................
............@...@.@...........
.............@.......@.....@..
....@.............@....@.@....
....@.................@..@....
...........@..................
.....................@........
........@..@...............@..
.............................@
...........@@.......@.....@@..
.....@......@......@..........
@.....@.@.......@.@.....@@....
........@.........@......@..@.
....@.............@...........
..........@...................
........................@..@.@
............@..@...@..........
.....@.........@..............
........@.....................
