30,30
...........@.........@........
...................@..........
.....@@@@...@.................
.@.........@......@...........
.@..........@.........@......@
...................@..........
..............................
.........@....................
..........................@...
...........@...@......@..@..@.
..........@.@.....@......@....
..............................
..........@............@.@....
.........@.@.@@...............
...........@..................
@........@...............@@...
...@....@.........@@.....@....
...............@........@.....
...........@...........@@@....
...@.......................@..
.@@..@.....@....@@............
..........@...................
@@........@......@....@.@.....
.....@.......@....@.....@.....
@....@.@.....@..@........@....
............@.......@.........
@........@.............@......
.........@....@.@.@.......@...
.............@................
..........@@......@.@.........
