30,30
.@..........@...........@..@..
........@............@.....@..
@.............................
..............................
.....@...@.......@.@...@...@..
..@................@.........@
@@....................@.......
.@.@......@..........@...@....
.@.........@............@...@.
......................@.......
...........@........@.........
.............................@
...................@.........@
..............@............@..
........@.............@.......
..@..@.....@.............@...@
........@...@.................
.....@................@....@..
......................@..@..@@
@.@......@.@..............@@..
......@............@......@...
........@@...........@....@...
..........@..@@@.@....@..@....
..@.......@.................@.
........@......@....@........@
........................@.@...
.............@..........@....@
....................@......@..
....................@.........
.....@.............@..........
