30,30
....@....@@...@.....@...@..@..
@....................@@..@....
.....@..........@....@...@...@
@.............................
...@......@@..................
....@.................@......@
..@....@..@........@..........
@@......................@....@
@........................@....
..................@...........
..@......@.@............@.....
.............@................
..........@...................
.................@..@.....@...
.@....@@....................@.
..................@...........
...........@.......@....@.....
.................@........@...
..@....@..@................@..
..........................@..@
.............@...........@..@.
....@......@.......@..........
..@...........@...............
.@............@.............@.
.....@@@...................@..
.....@.@...........@...@@.....
.@.............@........@....@
.....@...........@.@.......@..
.@..@.........................
...........@..................
