30,30
.......@.....@@...............
..........@............@......
......@.@........@............
...@...@...@.......@@.........
.....@.......@.@..............
.@.........@..................
........@.............@..@.@..
....@......@.@................
@......@.......@@.............
......@............@.@.....@..
...........@..............@...
...@.........@.@..............
..........................@@..
....@.....@@.....@............
.......@@..@.....@........@...
.......@.@............@...@...
..............................
.......@..........@...........
........@......@..@......@....
........@...@...@.......@.....
.@....@@...............@......
............@..@..............
.....................@@......@
..............................
............................@.
.....@.......................@
............@.....@...@@....@.
.....@................@....@..
....@....@....................
.@.......@...@......@....@....
