30,30
.......@.............@..@..@..
.............@..............@.
...@.........@.@.@............
................@.............
.......@...............@......
............@@..@...........@.
.........@..@.........@.@.....
..........@...@.@...@.....@...
...............@..............
....@.......@.................
..@...........................
........................@.....
........................@.....
.....@..@.......@@............
.@.....@......................
.@........@...................
..@.@.........................
@.@....@..@@...@..........@.@@
..@...........................
..@................@...@..@.@@
....@.@......@..@......@......
............@..@..............
....@...@@@..@................
.....@........@@............@.
.......@.@....@...@...........
................@.....@.......
............................@.
......@.......@.@..@...@......
.............@..@.........@...
............@.................
