30,30
...@..@..@..............@.@...
..........@..........@........
...@.@......@.................
....@.................@.......
.@..........@..@...........@..
.@.......................@..@.
.............@..@@..@.........
.....@.@......................
.......@....@............@....
......@.......................
..............@....@..........
..............................
.@@@.@........................
..@.............@..........@..
..@.@..@..............@..@...@
........@.......@..@..........
.........@......@.............
@.............................
.........@.@...........@.@....
....@.....@..@.........@......
............@.......@.........
.......@.........@............
........@........@......@.@...
.@..@...@@....................
.......@........@.............
......@......@@.....@@..@@....
...........................@..
.......@..@.......@...@.@...@.
.....@...@....................
..............@....@..........
