30,30
@.............................
....@..........@......@@....@@
............@................@
.........@....@...............
.....................@....@...
......................@..@..@@
..@......................@..@.
.....@......@.........@..@....
.@.........@...@.......@......
.........@....................
......@....@................@.
....................@.@..@....
@.................@...........
..........@..........@....@...
...@.@....@........@........@.
......@............@..........
.......@..............@..@....
.........@....@......@...@....
.@...........@................
....@....@...@........@....@..
.........................@....
..@........@...@.@..@.........
.@............................
............@..@...@.@........
@..........................@@.
@.............................
............@...@...........@.
...........@.......@..........
.@@..@.@.............@@.@.@...
...........@..................
