30,30
.............@..@.............
...@.................@..@..@..
................@......@...@@.
..................@....@.....@
................@...@...@.@...
.........@......@........@.@..
..@....@............@..@......
...@..........................
.@..........@...@.............
.............@..@@............
....@...................@.....
.....@.....@.....@.@..........
.....@.......@@....@..........
..............................
@....@..@...@.........@....@..
.......@............@..@......
..@...........................
@@............................
.@......@...@.................
..@......@........@.@.........
........@......@..@...........
@..@..........@.........@..@.@
..............................
@@.............@..............
..........@...................
....@......@....@.............
.@.@.....@.......@............
..@......@..@.................
..@....@..........@...........
...@.@...............@........
