30,30
.....................@.@......
..@.................@..@......
..............................
.............@@............@..
@@......@.....................
..@@..........................
....@.........................
.....@..............@.........
.........@............@@......
........@..........@..........
..@@.@........................
.......@.@.@..............@..@
....@.......@........@.@...@..
.....................@........
......................@....@@.
...@.....@....@.....@..@..@...
@.......@........@.@........@.
...............@..............
.........@..@...@.............
....@............@............
.......@........@.............
.......@@............@........
@......................@@...@.
..............@....@..@@......
......@........@..............
...@@...............@..@..@...
.@.@..........@@........@....@
.......@...............@...@..
..@..@........................
......@............@........@@
