30,30
.......@.@..................@.
.......@.........@........@@..
..@...........................
..........@@................@.
.....@.....@@.................
..............................
@....@....@.....@....@.@.@....
.....@........................
...........................@..
..@........................@..
...........@.............@....
...........@.............@@...
................@@....@@@.....
.....@.....@...........@......
.@............................
..@@..............@@....@.....
..@@..........................
..........@......@@.......@.@.
..@.........@...@........@..@@
.....@@.......................
..............@....@.@.@..@@..
..............................
....@....@...............@....
..................@..@........
..@.....@.@...@.........@.....
..............@...............
...................@.@..@.....
...........@................@@
.......@...@.......@@.........
@@...@...................@....
