30,30
......@.......................
@.....@......@@...@....@......
@...............@...@.........
......@.................@.....
..@..........@................
.................@......@.....
....@..................@......
...@....@.......@.......@.....
..............................
@....@......................@.
.......................@@.....
....@.......@.............@@..
..............@.@......@.@....
........@..@............@..@..
..@...........................
............@@...........@....
...@..........................
.@......................@.....
........@.....@....@..........
.@........................@.@@
....@...................@@...@
..........@..........@....@..@
......@.@@....@.......@.......
..@......................@....
@.......@.............@.......
........@...............@....@
.@.........@..................
..@............@..............
.....@..@.....@.......@...@...
.@@@......@..@..@....@........
