30,30
...............@..@...........
@......................@......
.......................@......
...@.@........@.......@...@...
.......@.@..................@.
..............................
...@...........@.......@......
.......................@...@..
@..........@...............@..
........@.@.........@@...@....
.@...@.@.........@.@........@.
..@.........@@..@.............
..................@.........@.
......@..@......@....@........
......@...............@.......
................@........@....
.................@.......@....
......@...........@.....@@....
..@...........@...........@...
..........@.....@.............
.@...@...@......@@.........@..
.....@@.....@...@.............
...................@..........
............@.@@............@.
...@.......................@..
.............@.@..........@...
@.@...@......@.@............@.
...@@.........................
...@.....@....................
..........@@@.................
