30,30
.@....@..@..@.................
.@..............@.@@...@.....@
.@@...............@...........
.....................@...@....
@......@...@..................
...........@.....@......@.@...
.....................@.....@..
......@...............@.@.....
..............................
................@.............
.@..........................@.
......@.@........@............
..................@.@....@....
....................@@.@..@...
............................@.
...................@.@........
..........@..........@...@....
.@..@........@@.....@....@.@..
.@.....@...@.........@.....@..
@.@.................@......@@.
........@.....@.....@.........
..............................
.......@...@...@@......@......
.....@....@......@............
.......................@......
...@...........@............@.
..@.....@..@..@....@..........
.........@@...................
@..........@..................
........@............@.......@
