30,30
..@........................@.@
.....@.....................@..
....@............@.......@..@.
................@.............
..@@..................@.......
@.@.......................@...
..........@.............@.....
................@.@.@.........
..........@...................
.@........@.@..@..........@...
@.........@..............@.@..
..@.............@.......@.....
.....@........................
................@.......@.....
...........@@.................
.........@.....@......@.......
...@@.......@....@.........@..
.....@.....@.....@.....@@.....
....@@.@....@.@..............@
@.@...@.....@..........@..@...
.......@........@.............
...@....@......@.....@........
.....@@.......................
.......@...........@..........
@....@........@.......@.......
......@...............@.......
..............................
..@......................@....
..........@.@...@.............
.@..@......@.....@........@...
