30,30
..............................
............................@.
...@.....@@............@......
..............@...............
...@.....@..@..@..@...........
...@...@...@..@....@...@......
......@......................@
.....@.......@..@..@...@......
.@...........@....@.@.........
..............................
.....@...............@.@.@....
.............@................
...........@...@.........@....
..@.....@.@.........@.........
.............@................
........@............@@.....@.
..................@.@..@@.@...
...@................@.....@...
............@...@......@......
...@@......@..........@....@..
...................@@.........
....@.@...@...@@.@......@.....
@...........@......@..........
..............@............@..
.............@................
................@.......@.....
........@............@...@....
...........@.@.@....@.........
..............@...@.........@.
...@........................@.
