30,30
.....@......@@............@@..
.........@.........@........@.
...........................@..
........@...............@.....
..........@@.....@..@.........
..@...............@@@.@.......
..............................
..@....@@.........@.@.........
........@.....@@..............
.....................@.......@
..............................
.@...@.......@................
......@.....@....@..........@@
.@...................@....@...
.@.@.......@.....@............
.......................@......
............@.........@.....@.
........@............@........
......@...........@.....@@....
..................@...........
...........@........@@.....@..
.............@.@@.@....@...@..
........................@..@..
..............@@..............
..........@.......@.......@@..
.@....@.....@......@...@.@....
@...............@......@..@@..
.............................@
................@.....@...@.@.
..............................
