30,30
...@.......@..@...@@........@.
...@......@............@......
............@............@....
............@..@@............@
@.............................
............@....@.@.@....@...
.........@....................
.@......@.....................
.........................@.@..
......@............@....@.....
...@..@....................@.@
......@....@@.....@..@........
................@.............
..@@..........@...............
.................@....@.......
..........@..@.............@..
@.............@..@............
.@.......................@....
.@.....@..........@...........
......@.....@........@.....@..
..............@...........@...
.@.....................@......
........@.......@..........@..
..........@..................@
...@..@............@...@.@...@
......@.....@.................
.................@............
............@..@.......@@..@..
........@.........@....@....@.
......@......@.@.......@......
