30,30
..@....@......@...............
@.......@..............@......
@...................@@......@.
..@....@.............@.@.....@
..............................
@..@.@.@............@.........
....................@........@
.........@.....@....@.........
..............................
.@........@.......@..........@
................@.............
@..@.....................@.@..
....@@...................@....
.@..@..................@......
.......@.@....@.......@....@..
..............................
@...@.@...@.........@.......@.
..............................
..............................
............@..........@@.....
.@...@......@..@...........@..
........@......@@...@.........
..................@@.........@
................@.........@...
...@.......@..............@..@
....@.@....@...........@..@...
....@...@...........@.........
.....@......@@..@....@........
..@.@.........................
....@.@.....@.................
