30,30
..@.........@@.............@..
.............@................
................@.....@......@
...@.......@..............@..@
......@....@.......@..........
@......@...........@..@.......
.@...............@............
.......@.@.........@..........
.....@..@.......@........@....
.....................@...@....
@......@........@.....@....@..
.....@..@..@@.................
.....@.......@@.......@.......
..............................
...@..@..................@....
.................@.......@....
.....@@............@..........
..@...........@.........@.....
......@@......@@..............
............@..@..............
............@.................
....@@............@...@....@..
.......@......................
..@.................@......@..
................@.............
..@........@..................
@...@...............@@........
@..........@@...........@....@
..............@...............
@...@.@....@@............@.@..
