30,30
@...@..........@..........@...
.......@......@........@@.....
..................@....@......
.......@.@......@.@.........@.
........@.......@.......@.@...
..@...@.......................
@.............@............@..
.@...@...............@........
.@..@.........................
......@......@.@@..@..........
..........@.........@...@.....
..@.@.......@............@....
........@........@@........@..
.....@...........@............
.........@.@..@...............
.......................@......
...@.....@......@...........@.
....@.............@...........
............@.................
.@.....@.......@..............
..................@.......@.@.
@....@................@.......
@@@@.@........................
.....@................@.......
@.@..@...................@...@
........@..@..................
..................@...........
.........@........@....@..@...
.....@........................
..................@......@.@..
