30,30
.....@....................@...
...............@............@@
.....@..@.........@.......@.@.
......@..........@............
..@..@.......................@
..@.....@.@....@...@..........
..@@@.................@.......
....@........@....@.....@...@.
@..@........@@..@.........@@..
..@..........@.@...@..........
....@....@............@....@..
@@............................
............................@@
.......@......................
@..............@..............
......@..@....@........@......
.....................@........
............@.....@.@@........
.@@...............@...........
@....@..@@.................@..
......@.....@.................
...@....@..@.@................
.......@......@@.......@......
.................@@@..........
...........................@..
..............@...............
@.....@.......................
.....@........................
......@.......................
.....@.................@.....@
