30,30
@...........@@.@.@@......@...@
@@@..@......@..@......@...@@..
..@.....@@.@...............@..
.........@.......@.........@..
...@.............@............
...@.@....@@..............@...
@...................@........@
..............................
....@.....@...................
....@......................@..
.....@.........@............@.
..............@...@.........@.
.....@..@......@..............
@........................@....
.@...@.....................@..
........@@..........@......@..
....................@.........
.@....@...@@.............@....
@.................@...........
..............................
..@.@..............@..@.......
..............................
..@.............@......@......
......................@.......
...................@..........
......@@................@..@..
....................@.........
...@.......@.....@....@.......
..@..@.................@......
.........@@...............@@..
