30,30
....@....@@@@..@......@.......
.....@..@............@........
...........@.............@@@.@
@.........................@...
....@.........................
.......@.......@..............
........@..............@......
....................@@..@.....
.@...........................@
............@@....@..@....@...
.............@@.............@@
@.@..@...................@..@.
............@@.......@........
..@..@........................
....@.........@...............
.......@......................
..............@..@............
..@..............@...@......@.
..........@@...@...........@..
@.@..........@........@.......
.................@..@.........
@...............@.............
..@.@.......@.......@@........
..@.......@.................@.
......................@.......
.@........@...........@@......
....@..........@.......@......
.............@@......@....@@..
..............................
..........................@..@
