30,30
.....................@.@......
.@........@..................@
...................@.....@....
..@......@...@................
..........................@.@.
.........@....@.@..@..........
.@....@.......@..@............
..@@@...@.....@..@............
....@......@.....@@..@...@....
......@................@......
.....@........@...............
.......@@...@.................
............@...@.............
..@...@...........@...........
................@.........@...
.....@.....@.........@........
....@......................@..
@.............@........@...@..
......@..............@........
....@........@.....@....@..@..
..@...@.............@....@....
.......................@...@..
@.....@@...................@..
.@.........@..................
.@......@.....................
..............................
.......@..............@..@....
.......@..................@.@.
@.......@.......@.........@...
...........@..@..@.......@....
