30,30
@..@...@..........@@..........
.............@@.............@@
........@....................@
...........@@.......@........@
.......@..@.@...@.............
...@.......................@..
..@...........................
@.....@...@.......@...........
...@..........................
..@.@....@...@......@......@..
...................@@.........
...........@.....@.@..........
........................@.....
...............@..@@..........
.........@.............@....@.
....................@.........
..@........@..........@.@.....
.............@................
......@..@.........@....@@....
@.........................@...
...........@..................
.......@....@..@.....@......@.
....@........................@
...@...@....@...........@.....
........@..@...@........@.....
@.....................@.......
............@.@.......@.......
...........@....@.......@.....
.......@...@.@..@.............
..........@..@............@.@.
