30,30
...@....@.@.................@.
...........@.@.@..........@@..
@...@..@.............@........
...@............@.......@....@
....@...@.............@@......
.........@..@.................
.........@....@...............
..@................@......@...
....@...........@.............
.......@.@....................
.........@..@.................
....@@......@.....@...........
.............@.@....@.......@@
..@..@........................
.........@....................
................@.@.@.@.......
....@............@............
..............@...............
....@........@..@...........@.
@@............................
..@..@...........@...@........
........@...@.................
...........@..................
....@..@...........@@...@.....
...@..............@@..@@....@.
........@..............@......
........@.............@@....@.
..............@...............
.@.................@..........
..........@...@.......@..@....
