30,30
.................@............
..............@.@...........@.
..........@.@...............@.
..@...........................
....@@@.........@..@......@@..
@....@........@...............
...@.@....@@@.................
.....@..........@.@....@......
.......................@......
......@......@...............@
........@@.@........@.........
................@.@.@.........
....@.....@..................@
.......@............@.........
...........@..................
.@.................@..........
......................@.......
...@@.@..@......@............@
.@..............@......@......
...........@.@................
.............@..@...........@.
.............@..@.............
.........@....................
..@..@.....@@..........@......
@..................@...@....@.
......@......@........@......@
........@.....@..........@....
.@............................
.@.@.........@..........@.@...
............@...........@@@...
