30,30
.........@..........@..@@..@..
...........@..........@.......
............@......@.........@
.@.....@.....@................
..@....@....@.@.......@.......
.@..............@...........@.
..........@...........@.......
@........@.....@@.............
...@....@.....................
.........@...........@...@....
.@......@.....@@...@..........
....@.......@......@..........
@...@..............@.@........
....................@.........
...@............@..........@..
@....@..@......@..............
.......@..@....@.......@......
.......................@......
.............@......@...@.....
...@.............@............
.....@.................@......
.@...@.................@......
..............@........@....@.
@...@....@............@...@...
.........................@.@..
.......@...@..................
...@...@..............@.......
@..@...................@....@.
..............@..@............
.........@......@.............
