30,30
.....@...@....................
.......................@...@..
.......@..................@...
........@.....................
..@..@.....@.@...@....@.@.....
.@@....@....@@....@..@........
@............@.......@........
..@..............@....@.@.....
..............@.@.............
.........@..@.............@...
..................@...........
................@......@@.@.@@
........@..........@....@.@...
...@....@......@..........@...
....@........@...@............
.......................@......
..@..@.@@@....................
.....................@@.......
..@...........@.........@.....
............................@.
.......@.@...........@........
@...................@.........
.......@................@...@.
.........@..............@.....
..@......@..@.........@.......
........@.@...........@...@...
...@.....................@....
...@.......@.........@........
.......@..@...................
................@.....@.......
