30,30
....@@@....@.....@.....@.@....
.......................@......
........@........@......@.....
..@...........................
.....@.......@...........@....
..............................
...........@...........@...@..
....................@@........
..............@.........@.....
.........@.................@.@
.@.......@.........@.........@
.......................@....@.
.@................@......@....
.......@.@@@.....@.......@@..@
.@.@..........................
...@.....@........@...........
............@.....@...@.......
@...................@.@.......
..@.@........@...........@...@
..@..@.............@........@.
.........................@..@.
...........@..................
......................@.......
.....@.............@.....@@...
.............@.@...@..@.@.....
......@@........@.....@@......
..........@.........@.........
..............................
.....@.............@..........
.@@.......@..@...@...@........
