30,30
....................@..@......
@.....@@..................@...
.....@.......@................
...@..........@@.......@......
..............@............@..
..............................
...........@..@............@..
.......@.@........@@..........
..............................
......@................@.@....
..............................
.....@.........@..............
...@...@......@.........@...@.
.@@..@.......@........@...@..@
..........@...@..........@....
......@................@@.....
.....@@.@..@........@........@
.@...........................@
...@..@..@..@@....@.......@...
..........@..........@..@.@...
.......................@.....@
............@.......@.........
......@.@...............@...@.
.........@..@...............@.
...@..................@......@
.........@..@..@..............
.......................@......
....................@.....@@..
....@..@.@............@.......
..@.............@.............
