30,30
.............@........@.......
.@..@...@.....@...............
@@.................@@.........
.........@............@..@....
.........@..@..........@.@...@
.......@.....@.............@@.
.@............................
.....@@....@..................
.@.....................@......
.....@.......@.........@......
.@............@@@.@...........
....................@....@....
.....@........................
...@.......@.@.@@........@....
...........................@..
..@....@.@.......@......@.....
...................@.........@
.....@.@.............@.@......
@...............@.............
..............................
.@.....@......................
.................@.@.@........
..........@...@...............
..........@...........@.......
.............@@........@...@..
...@......@..@@.......@.......
..............@............@..
....@......@..@....@.....@@...
....@.....@...........@.......
.@.........@..................
