30,30
...........@...@..@...........
@........@....................
.........@.......@.......@....
..@......@.@.....@...@..@.....
.....@...............@........
@..........@........@......@..
..............@......@@.......
.@.....@..@.......@.@.@.......
....@.........................
.@............@............@..
....@.@......................@
........@.....................
..............................
@..........................@..
...........@.@@....@@........@
@..........@..................
.............@.....@....@.....
..@.@.........................
@...@.@..........@............
............................@.
.......@.........@...........@
.@......@....@.........@@.....
..........@@..................
.@....@....................@..
......@@....@....@............
.@.@.....@.....@..............
............@....@............
...........................@..
..@@....@.......@............@
@...@..@..@...................
