30,30
..@@..........@.........@.....
.............@.........@.....@
@.................@.......@...
....@@.....................@@.
.........@....................
.........@...@................
..................@...........
@.........@......@............
................@........@....
.@.@@..@...@....@......@......
....@.............@...........
...@........@.@...........@...
@.............@...............
.............@....@...........
..............................
.....@@.....@@................
......@......@............@...
@...@...@....@.....@.@.@....@.
............................@.
.@.........@..................
.......@..@.................@.
....@.@...@..............@....
@........................@....
..@...........@.....@.@@......
...@.....@.......@.......@.@..
.@......@.....................
..@.....@...@.................
.@............................
.........@......@...@.........
.@....@.......@....@..........
