30,30
...@....@....................@
....@..@...@..................
...@...@..............@.....@.
.................@............
......@......@...........@....
..@....@..@...................
@@@.@..........@..............
...............@........@.....
@............................@
.................@.....@.....@
...@................@.........
...@............@@............
..........................@...
...@.......@.@..@.............
.@............................
............@.....@..@......@.
.....@.....................@..
........@@....@............@..
@@......@.....@@......@.......
........@@.......@.....@......
.@@...........................
...................@..........
..........@....@..@.......@...
........@.........@@..........
...........................@..
....@.........@@............@.
.......@...@.......@......@.@.
....@@.......@..@..@..........
..@.............@.............
.........@@......@............
