30,30
@@....@...@......@............
.............@..............@.
..............................
...@......@........@..........
.....@................@.......
..@.......@..@.@....@.@.......
@..@...........@..............
@..........@....@.......@.@...
.....................@.....@..
.......@............@.....@..@
.@............................
.............@.@.....@.......@
........................@.....
.....@......@.................
.....@......@....@............
.........@...@@...............
.......@.@@........@.....@.@..
.........................@....
.@.........@.@.............@..
@...........@.........@.......
.....@.......................@
....@....................@....
..@....@...........@.........@
...........@..................
..................@....@......
..@..@...............@@...@.@.
..@.@......................@..
...@....@@...@................
...@..@..............@........
....@........@..........@.....
