30,30
@..@...........@.@@...........
@.@....@..........@...........
......@.....@..@..........@...
....@..@..@.......@..........@
.@.....@............@......@..
..@..............@...........@
...............@..............
@........@.......@..@.....@...
...............@.............@
..............................
...................@..........
....@.........................
...............@@....@........
@.@...............@...@@......
................@.............
.....................@.@......
...@.@.@..............@@......
......@............@@..@.....@
............@...@@@...........
......@....@..............@@..
.@...@.............@..........
.@.@..@........@..............
........@.@...................
...@...............@..........
........@.....................
..........@....@..@......@@@..
.......@........@.....@....@..
.............@.@..............
...............@..............
...@..........................
