30,30
..........@...................
@@.......@.@..........@.......
................@..@.......@..
.....@..@........@..@.........
.........@............@.......
....@.....@.@...@......@......
.....@.@...@..........@.......
......@.............@.........
..........@...........@.@.@.@.
.@.......@................@...
....................@..@......
.........................@....
..@@...........@..............
.........@.......@...@@.....@.
...@..............@.....@.....
..........................@..@
....@...............@.........
..............................
........@.....................
.......@..............@....@@.
@....................@..@....@
..............................
........@...@.@..@...@@.@.....
.....@.@..@...@....@....@.@...
...@............@.@...........
.@.................@..........
...........@.@.........@....@@
..@...........................
........@............@........
@......@......................
