30,30
..................@..........@
..................@...@.......
..........@................@..
...........@@@................
.@........@.............@.@...
.......@..@.@@...@............
.....@......@..@.............@
............@...............@.
.@.@..@..@.@...............@..
@.......................@....@
.......@.@............@....@..
......@...............@....@@.
....@.........................
@@.............@...@..........
...@..........................
..@.....@.....................
.......@....................@.
.........@.@.@.....@.....@....
...........@.................@
......@.......@....@.@......@.
.@.......@....................
.@.....@........@........@....
....@.........................
........................@..@..
..@...@............@..........
....................@@.......@
............@.........@....@..
..................@..@........
@.........................@...
.....@@.@....@...........@....
