30,30
@...@..........@.............@
...............@..@...........
..............@...@.......@...
.......@....@...............@@
.....................@........
.........@............@.......
.....................@........
......@...@...........@.@.....
...........................@..
.................@.@..........
..@.@...................@.....
...@.....@@..............@.@..
@......@...@...............@..
..................@.@......@..
.....@..........@.......@....@
.@....@......@.....@@........@
.................@......@.....
.............@@.............@.
.@..................@.........
......@@....................@.
........@..@..............@...
..............................
....@..................@...@..
.....................@........
.....@..@.....................
...@...@.......@..............
.@....@....@...@.......@......
.@.........@......@@.@@.....@.
.............@..........@.....
..@..@...........@@..........@
