30,30
..............................
........@................@....
.................@............
....@@....@...@...............
......@.............@...@.....
@@...............@............
...@.@..@.....@............@..
.@..@.......@.@...........@@..
@....@..@.@..............@....
...@.................@.@.....@
..........@.........@.........
@.......................@.....
................@.............
..............................
......@.......................
.@..........................@@
....@@@....@.........@........
.@.@...........@.....@@.......
..................@.......@...
.@................@.@..@..@...
..............................
@.....@...@...................
....................@.........
@.@......@.....@@.......@.....
...@@.....@....@...@..........
@.@......................@...@
..............@.........@.....
...@..@.......@.@.........@...
@....................@........
...........@@..........@......
