30,30
........@......@..............
...@.................@........
........@....................@
@.@.....@........@............
............@..........@...@..
.@.......@....................
....@...........@.............
.....@..........@....@........
.......@......................
.@.@.@.@.........@...........@
.....................@.....@..
...@.....@....@...............
........@.....................
..@......@......@.............
.............@..............@.
...@.....@....@.@...@.....@...
.....@...@.........@..@......@
.............@.............@..
....@.........................
..................@...@.@.....
..@...@......@.....@....@...@.
................@.............
.....@.@..@...@...............
@.........@@.@..@.....@......@
............@@@...............
........@@.....@....@.....@...
...@..@.....@.@...............
...@..........................
.....................@........
....@........@..............@.
