30,30
.......@..........@...@.......
...............@..............
...........@.......@..........
.@.....@....@..@....@.........
..@.........@.@..........@.@..
....@.........................
..@..@@...............@.....@.
......@.............@........@
@..............@..............
...................@.........@
@..@@...@@....................
....@..@.............@........
.........@..@....@............
.@...........@..@......@.....@
@.............................
..............@...@...........
....@....................@@...
....@.......@....@...@........
...@.....................@....
.......@...@....@..@..........
..........@...............@...
.@............................
.........@............@..@....
@.................@...........
......................@......@
.@.....@.............@.@......
........@..............@@.@...
.....@........................
....@@........@.@..@..........
..@......@@.............@....@
