30,30
..@.......@.....@..........@..
.......@......................
....@....@.....@....@....@....
@......@..........@...........
........@..@.............@....
...@.@...@....@.............@.
............@.@...@...@.....@@
@.@................@..........
...................@......@...
....@.@..@@.....@@.@..........
..@..........@@...............
..@@..@.@..........@.....@....
..............................
...................@@.......@.
...........@..................
......@...................@..@
@...........@..@..............
....@......@...@....@.........
@............@.....@@...@.....
@.......@..@...@.@............
...@....@@....................
......................@.......
..............................
..............................
...............@..............
.............@................
.....@........................
....@@.........@..........@...
@..@......@........@..........
..........@............@@.....
