30,30
..............@...............
@...............@@....@.......
@......@..@...................
..........@..............@....
...................@.@@.....@.
................@............@
......@.........@.@.........@.
....@.........................
@.@...@...@.@..........@......
.......................@...@.@
....@..........@.......@....@.
.........................@....
..@................@........@.
......@.........@.....@.....@.
..........@...@.............@.
...@...............@..........
.....@......@......@..........
.........@....@..........@....
..@..@.@......................
..............................
.......@....................@.
...........................@..
......@..........@......@.@...
..............@....@...@..@.@.
..........@........@......@...
...@..................@.......
@........@...@.....@..........
.....@.@.@....@....@@....@....
..........@.......@...........
..@...........@@...@..........
