30,30
@...........@................@
....@..........@.@.....@......
.......@...........@......@.@.
...@.............@............
..............................
..............................
....@.....@....@@.....@.....@.
.........................@....
@........................@...@
.@.................@@.........
.......@.@....................
..@...@.@..........@..........
..............@...............
...@...@................@..@..
...@@.......@.@...............
.....@........................
............................@.
..@........@............@.....
..@.........................@@
.....@...@...........@........
...@...@.....@............@...
.@...@..........@......@......
@.....@..@.@..................
....@......@..........@....@..
.@..@......@.................@
...........@..................
......@@...@.....@.....@......
@..............@.........@.@.@
@.@.@..............@..........
........@....@............@...
