30,30
....@@.@......................
.........@............@.......
......................@.......
.....@...@.....@.@............
.........@@.................@.
@.........@......@@.....@.@..@
........@...@............@@@..
...........@.@................
.....@....@...................
...@........................@.
....@........@................
.................@............
.....@...@....................
..@@.......@....@.............
.....@........................
....@......@..................
...@.................@........
......@.@.......@.@...........
..................@...........
.......@...@.@....@.@...@.....
........@.....................
..@...............@..@@.......
.......@......@..............@
....@........@....@...@.@.....
.......@......@........@......
.....@........@...@......@...@
.....@....@.......@........@..
.........@.......@.....@......
.............@.@...@..........
@...@.............@...........
