30,30
.............@............@...
......@..@....................
............@.........@@.....@
..........@.....@.@.......@...
.@.....@......................
......@..@.............@.....@
@...........@.......@...@.....
........@.....................
.@@.......@....@@...........@.
..............@.....@.........
..................@......@....
..........@....@@.............
.....................@......@.
.........@..@.................
...................@..@.......
..........@@...@.@............
...................@.......@.@
............@.....@...........
....................@....@....
..@......@............@......@
...@.....@.@..................
..@.........@.................
............@...@.@...........
.................@......@.....
.@...@.....................@..
...............@@............@
@.@.................@.........
........@.........@......@....
....................@....@....
..@@.@.@.@...@......@.@@......
