30,30
.........................@....
......@...@...................
@.@.............@.............
.............@....@...@.......
...........@..................
.....@.@.@@...................
..@......@@.............@...@.
.............@.........@......
.@.@..........................
..@.@.............@...........
.......@............@....@....
......@.......................
........@.@..........@........
................@...@.@...@...
.@.....................@....@.
.......@.......@.........@....
....@........@@....@..........
.............@................
......@..........@@...........
..............@...@...........
...@....@@@.@.................
...........@@.@.........@.....
.......@......@...@.@....@...@
.....................@@.@..@..
..@@...@.....@.....@..........
.........@.......@..@.........
...............@@.........@.@@
....@.......@.......@@........
..................@...........
..............................
