30,30
.................@.@..@.......
.@..@........@................
......@...@..@................
....@...........@...........@.
.................@@.@.........
..@......@.....@..............
.............@..............@.
..............................
...........@..................
.@...@............@.........@.
.@......@.........@@@........@
...@...............@..@.......
.....@..@.....................
........@...@...@.........@...
.................@............
.@.....@....@.@.....@.........
......@..............@@@.@....
...@@...@...........@.......@.
........................@.....
....................@.@@......
.....................@.......@
.@.......@..........@.......@.
..............................
............@.................
.......@..@..........@....@.@.
...............@..............
.....@@.....@....@.........@.@
.@...........@...........@@...
......@....@.@.....@........@.
......................@...@...
