30,30
..............@......@........
..@....@.............@.......@
...........@...@..@@......@...
....@....@....................
.....................@.......@
...........................@..
.....@..@....@.............@.@
........@.......@..@..@.@.....
@.......@.....................
..............................
......@..........@...........@
...@..........................
................@.........@...
....@..@......@@@.........@...
.....@........................
.........@.@..........@.....@.
@.....@...@........@@.........
@@.................@...@......
..............................
@...@.....@.....@..@.....@..@.
@........@..@.......@.........
...@........................@.
.@.....@..@......@......@..@..
@...@....@....................
.........@.....@..........@...
...@.....@....................
.........@...................@
....@......@.....@............
.................@............
.......@.........@..@.........
