30,30
.......@...@.@...@............
.@........@..@............@.@.
......@.............@.........
..@...................@@@.....
...@.......................@..
............@.................
..................@........@..
.@....@............@..........
@.......@...@.........@.......
...........@..........@....@..
..@...........@.........@@....
...@.....@....................
......@.@.......@.............
............@.....@.........@.
.............@................
.......@........@.....@.......
....@.....@.@.@.....@.........
....@.........................
....................@......@..
..............@@...@.@...@....
.....@......@........@........
......@..............@....@...
..@...........................
@.@...........................
......@.....@.........@.......
......................@.......
...........@...........@.....@
......@@.......@.@@..@.@.@...@
............@.......@.........
.@......@....@....@...........
