30,30
.@........@.@..@........@...@@
........@..................@..
.....@.....@..................
@....@@....@..................
.....@..@.@.....@.....@.......
.......@....................@@
..............@............@..
...@@.........@......@........
................@..@@.........
@.............................
........@.....@...............
.............@................
..............@........@......
.@..@...@.................@@..
....................@......@@.
.@....@.......................
............................@@
........@.......@...@@......@.
..............................
.....@........................
..@..@...................@@...
...@@............@....@.......
...............@....@...@@..@.
..@..@...............@........
........@...........@......@@.
..@..........................@
.............@.@.@@.........@.
.................@..@.........
............@....@............
.....@.......@...............@
