30,30
......@@..@............@....@@
..............@....@..........
@.....@..........@.@..........
.......@.....@..@........@....
..........@............@......
..........................@.@.
.....@........@..@............
.@.....@...................@..
.......@...............@......
@.....................@..@....
.......@.........@.@..........
.....@.@...@....@........@.@..
...@..@..@@...................
@..@.................@..@@...@
..@....@..@...................
@.................@.@.........
....................@......@..
...@.....@....................
....@......................@.@
...@..........@@..............
.@..............@...@@........
............@.................
..............@.@.............
..@..............@............
..............................
.....................@@......@
........@............@........
..@....@.........@............
.......................@..@...
....@.......@...@....@.....@..
