30,30
..........@.......@...........
..........@.@....@............
@........@.........@.@........
.....@@.@@.....@.@......@.....
................@...........@.
.............@...@............
.............@..........@.....
...@@.@.@..@.@.@....@.........
......@..................@....
@.............................
.....@............@...........
..............@...@.........@.
.................@...@........
..........@.@...........@.....
..@...@......@...@..@.@..@....
...........@....@@.....@......
.....@....................@...
..............................
......@.................@.....
..@@...........@.............@
..............@...@..@...@...@
.@..........@...@........@....
@.......................@.....
@.......@..................@..
.........@....................
.............@............@...
...................@.@...@....
...@................@@........
...@..........@@.@..@.........
..............................
