30,30
....................@..@......
..............@.......@.......
..............................
........@........@.........@..
@........@...............@....
........@....@.......@.......@
.......@...@.@................
......@@...@@.@........@..@...
.....................@.......@
.@@...@.......................
.........@.......@..........@@
.................@.......@...@
..........@...@..............@
@..@....@....................@
.......@@.@..................@
........@........@..@@..@....@
.......@@@...@....@...........
................@@..........@.
.............@........@.....@.
....................@@........
@.............................
.......@...........@..........
........@..@......@...........
..@...........@.@.............
.@..@..@...@..................
..............................
........@....@....@...........
......................@.......
@...@........@...............@
...@.....@.......@............
