30,30
@@............................
.........@@..................@
.@................@...........
@..@.@........@...............
..@.................@.........
....@.........................
...@.....@.............@......
....@@.@.............@..@....@
............................@.
...@..........@...............
...................@.........@
.........@....@.....@@....@@..
.................@.....@......
..............................
.@..........@@....@...........
...........@......@.@.@.......
...@.....................@....
......@........@......@.......
.........@@....@........@@.@..
@.....@......@..@....@...@....
..............@..@@@....@.....
................@...@......@..
..............................
.........@.......@............
..........@@...............@..
..........@@..................
..@......@@.............@.....
.........@@......@..@......@.@
.........@....................
........@..@................@.
