30,30
.................@............
..@.........@.......@.....@...
..............................
..@.@.................@.......
...........................@..
..............@...@...........
@......@..@....@....@.........
@.@...........@...............
....@.................@...@@..
....................@.@.......
.@........@..@....@...@.....@.
......@............@.......@..
........@.................@...
.............................@
@....................@...@....
.......................@......
.......@...@@..@.............@
.........@.......@.......@....
.@....................@......@
.@.......@.@..................
..@..@@............@...@......
@.........@....@@@............
.......@.....@.............@..
.......................@..@...
......@.......................
.................@.@..........
@.....@.@...@...........@..@@.
...........@.......@..........
......@...............@.....@@
........@..@.....@...........@
