30,30
@.@@@.........................
.............................@
...@@...@@.@...@..............
...........@..............@...
........@...........@.........
......@..............@...@....
....@.........................
.......@...........@.@........
...@..........................
..@@..........@@@@.......@....
....@......@.....@..........@.
..@@........@............@....
@..................@....@.....
....@..@........@.............
..............@..............@
..............@...............
..@....@...@...............@..
..@.@..............@....@@....
@.@....@....@..@@.@....@......
..............................
..@..............@............
......@...@...................
....@.@..........@....@@......
..@.......@........@..........
...................@...@..@...
.....................@........
..@@.......@....@.............
..............................
....@@..........@.............
@...............@...........@.
