30,30
.....@...........@..@@...@...@
.........@....................
...@@...@............@@@......
..@.....@..@.............@@...
........@......@..............
.........@........@.@.....@...
...@..........................
..............................
..........@............@..@...
....@..@...............@......
.............@........@.@.....
......@@.....................@
.....@@...@......@........@...
..@.........@@.........@......
..@...@.........@.............
..@...@.......@......@........
.@@........@..................
....................@......@..
@...................@.........
......@.@.....................
...@.....@.....@..............
.@............................
...........@.@.............@..
.........@....................
.....@.......@....@....@......
.......@.................@....
..@..@...@.....@.........@....
..@...@...........@...........
...@...........@..............
.@@..............@......@.....
