30,30
..............................
....................@.........
..@......@.......@@@..@....@..
.....@....@.................@.
.@.....@@........@.........@.@
.....@.............@..........
.@...................@........
.........@.@@....@..@.........
....................@........@
.....................@....@.@.
.....@...@.....@.......@......
..@...............@..@........
...............@....@@........
.........@@........@..........
................@....@....@...
.................@............
....................@.........
.........@...............@....
...@......@............@.....@
........................@.....
......................@.......
@@.@.................@........
@.......@.@...@........@....@.
...........................@..
.@....@.@...........@....@....
....@..................@...@.@
..@.....@..........@.......@..
................@..........@..
....@@..........@.@.........@@
.............................@
