30,30
........................@.....
.@...@......@.................
........................@.@...
...........@..................
..@.........@..............@..
...@....@.....@..........@.@.@
.@.@.........@@......@.....@..
....@......@......@....@......
..................@@..........
@.....@.@....................@
..@.........@.................
.............@....@...........
..........@...@..@.@........@.
.........................@....
.@@.....@.....................
...........@...@........@.@..@
..@...........................
.............@@.@.............
..@.......@.........@.@...@...
.....@........@...............
.......@.........@.@.@........
...@@@....@...........@.......
.......................@......
.@...@.........@..............
..............@......@.@..@..@
.........@.......@............
....@......@......@@..........
.................@.....@......
.......@......................
...............@@.............
