30,30
........@....................@
..............................
@@.............@..............
...@..........................
@........................@..@@
@.@....@..@.............@...@.
..............................
.............@.@.........@....
........@.........@...........
..@....@@............@........
..@...........................
....@..@............@.........
.......@.............@........
..@...@........@..............
...@........@.@.........@....@
.......@...@...@.............@
...@.......@.@................
.@......@...........@.....@.@.
...............@......@.......
.@@..........@...@............
...................@@.@.......
...@...................@.@@...
..............@@......@.......
@....@.@........@.......@.....
....@........................@
..........................@...
...........@@..@@.....@......@
.@.........@..................
...@........@@......@.........
.................@.....@.....@
