30,30
......@..........@....@.......
............@.......@.........
.........@....@...............
.........................@....
..@........@..............@...
@..........@..@...............
......@..................@....
......@..........@............
.............@..............@.
..@.@.....................@..@
....@..@...@...@..............
..........@...................
.............@............@...
...@.....@.......@....@@......
.........@@............@......
....................@....@....
..............@...............
.........................@..@@
........@.....@..@@@.........@
.....@........@.@........@.@..
.........@............@....@..
...@.@....@.....@.............
.@........@.....@............@
.......@.........@....@.......
.....@....@......@......@....@
..@.....@..@...@..............
......@..........@............
.@.......@..@........@........
....@......................@..
..@.....@................@....
