30,30
....................@.........
......@.............@.........
.....@..@@................@...
...............@...@@.@......@
.@............................
...........@..............@...
..@......................@....
.@.......@......@.......@..@@.
..@.........................@.
...................@..........
.@....@........@..............
..@...@.........@.@...@..@....
......@........@..@......@....
.....................@...@....
.........@......@.........@...
........@.........@..@........
............@.................
@.................@@.@.....@..
..............@.........@@....
.....@....@.......@.........@.
..............@..............@
....@.....@............@......
..................@...........
................@.........@...
....@................@@...@@..
.........................@....
........@..@@..@@..@.....@....
...............@.........@.@..
..............................
..@...........@.@.....@.@@....
