30,30
..................@.....@...@.
.....@@....@...@.....@........
....@........@....@....@......
...@...................@.@....
.......@.@....................
.......@..@.........@.........
..@..@..@.......@@..@.......@.
..............................
..@.....@.........@.......@.@.
.@..........................@.
...............@...@....@...@@
.@........@............@...@..
..........@............@......
..............@..........@....
..................@.........@.
.................@............
.................@............
..@........@.....@.......@....
...@.........@............@..@
............@..@.........@@...
....@.........................
....@............@..@@..@.....
..............................
................@.....@.......
......@.....@....@..@.........
....@@.........@..............
...........@.......@..@.......
........@.....@.........@@....
...@..........................
.......@..@@........@.........
