30,30
.......@@.....................
.@.@...@.@@..@................
...@.......@...........@......
@...........................@@
.......@......................
....@..@....@.................
...........@.....@............
................@...........@.
@..@...@.........@.......@....
.................@............
..........@............@......
...........................@..
..........@@.........@...@....
.......@.@@@........@..@......
..@.......@...@@..............
.@..................@..@......
...@.........@....@........@..
........@...............@@@...
..@................@.......@..
...@.........@............@.@.
..........@...................
............@.................
................@.............
@@..@.@......@.....@..........
.......@...@.....@.......@@...
...@..........................
...........@....@.........@...
...@........@.@...............
.@@...@..............@........
........@....................@
