30,30
..........@.@..@..............
......@.@...@..........@......
.....@.....................@..
.@...@...@....@.............@.
....@.......@...@.............
............@...........@.....
....@@........................
.....@............@...@.......
...@.......@.....@............
...........................@..
.....@.......@....@...........
.....@..@..@.......@..........
.....@........................
........................@@.@..
..........@@@......@..@.....@@
..@..........@......@.........
..................@...........
.@.........@......@@..........
..............................
...@...............@.........@
.......@......@...............
.............@.@..@..........@
...........@@...@.............
...........@.....@....@.....@.
@.............................
........@.....@......@.@....@@
.............@................
.@......@........@............
.....@.............@..........
....@@.@................@..@@@
