30,30
....@.............@.....@@....
.............................@
@................@..@.........
........................@....@
.....@@..@.............@......
.@.......................@....
......................@.......
.....@..................@....@
..@.................@.........
.@......@@...@@@.......@......
......................@.......
.......@@.............@.......
....@@......@...@.....@@......
......@........@..@@..........
...@....................@.....
.............@.......@......@.
........@.......@.............
.........@@....@..@.......@..@
........@............@........
.@............@...............
....@..............@.........@
..................@..@.......@
.................@...........@
..@................@..........
.........@...@..@.....@.......
....................@........@
........@....@..@...........@.
..................@@..@.......
.@..@......................@.@
.................@..@..@......
