30,30
@...@....@............@.......
...@@..........@...@....@.....
................@..........@..
.....@............@...........
................@..........@..
.@.@........@......@.@.....@..
....@............@............
..........@.@.....@.@.........
...@........@.........@.@.....
..@......@.............@......
.....@.@........@.............
..............................
.............@.@...@..........
..............................
..@@.....@........@....@......
...@..........................
@......@.@...@.......@........
@..................@@......@..
....@.@.........@.............
.....@.@......................
.......@.........@.....@......
.......@..@...@............@..
.........................@....
....@....@...............@....
...............@..........@..@
..............@...............
.@.@...@.....................@
@....@.........@@.............
.......@............@.@.......
.......@.....@......@.@.......
