30,30
.............@....@...........
......@.......................
.@..@.....@................@@.
........@.@.................@.
........@@@.@.................
....@.........................
.......@................@.....
..@@.@........................
.............@................
@....@.........@..............
..@........@............@.....
...................@.@.@......
...........@@.........@@......
..@.....@.....................
................@@...........@
........@.@......@@.@@@..@....
..............................
....@...@...@.............@@..
..@...........................
...@..................@.......
.@........@...................
.............@.....@....@....@
.@..@@..............@@........
......@........@.........@....
..............................
.............................@
@@......@........@...@...@....
.@.....@.@....@.....@....@@...
.................@@@..........
....@....@.@..................
