30,30
.......@...........@.@........
.....@....@................@@.
..@....@@....@...@.........@@.
...@@@......@......@.........@
..@..........@.....@..........
@.............................
..............@....@@..@......
.............@..........@.....
..............@...............
..............................
@....@..........@..@..........
................@.............
...@@...............@.........
......@.....@@..@.......@.@..@
...@....@.....@.......@....@..
...........@..................
.@................@...........
...@..@.......................
@.......@...........@.........
@.@.................@.........
....................@.@.......
..............................
.@..@.....@...................
..@....@.................@..@.
.............@..@......@...@..
.................@..........@.
...@@.@..............@........
..@.@......................@..
.......@.......@..............
@.....................@@.....@
