30,30
........@.....................
...................@..........
.@...@...@...................@
....@..........@...@....@.....
..@....@..@.@...@.@..@........
....@.@.......................
..@...........................
.....@..................@.....
.......@@.....................
.....................@.@......
.@....@............@..........
........................@.....
.@..............@........@....
.........@....................
.....@.........@@.............
.@......@..............@....@.
..............................
.@..........@............@....
......@......@..............@.
..@.......@..................@
....@...@.@....@@.............
......@..................@.@@.
.................@............
.......@..@.@........@...@..@.
..@..@........@@.......@......
...@...........@...@.....@....
........@...@.................
..........@.@.@.....@.........
..@........@@..@..@..@........
..............@......@......@.
