30,30
..................@...........
....@......................@@.
@...............@.......@@....
....................@.........
.....@..@@...@................
..............................
....@..@..........@...@.@....@
..............................
.@.........@@..........@......
......@........@....@.....@...
...@...@...............@......
........@@....................
.@.........@.@.............@..
..............................
......@...@.....@..........@..
.....................@@.......
..@...@.......@.....@.........
@@..........@...........@.....
.@.......@....@........@....@.
...................@@.........
....@.....@@.....@.........@..
.......................@......
..@.@.........................
..@...@...........@...........
..........@.................@.
...@.......@..................
@@...@............@.......@...
@......@@.....@...............
.@....@@@@@............@......
..........@...............@...
