30,30
@............@...........@....
..@@..........................
...@.....................@@...
.....................@........
.........................@@...
..............@@@.............
........@.@....@..@.........@@
.@@..@.@@.@.....@............@
.........@....................
...........@.........@........
.@@....@......................
.@..................@.........
.............................@
.........................@....
...............@.@........@...
@..........................@..
..............@...............
...........@.@......@.........
.@........@.....@@.......@....
.@@..........@.........@......
...........@...@.........@....
@...........@.................
.............@....@@..........
.@@..@.......@.......@....@...
.@...@..@...............@....@
....@............@.........@..
........@........@............
......................@.......
@.......@...@..........@......
.....@...@.@....@..@..........
