30,30
......@.......@......@........
.......@..............@@......
....@..........@..@...@.......
..........@..@.........@......
....@.............@.....@....@
..........@.................@.
..@...........................
.....@............@...@.......
...........@.......@@.........
..................@..@.......@
..................@....@......
..........@.................@.
...........@.@...@...@.......@
.......@....@.........@.......
.......@....@..@@.............
..........@......@............
@...............@...........@.
...................@.@.@......
@.@..........................@
....@.............@...........
.........@.........@........@.
...........@..........@.......
.@@...................@@@.....
..@.......@..........@.......@
.......@.........@..@@........
.........@.....@.....@....@...
............@.......@.....@...
...@........................@.
...@....@...............@.....
......@@......................
