30,30
......@.........@...@....@.@..
.....@..........@.............
@...@...............@...@.....
......................@.......
.................@............
...............@.......@......
...@....@.............@.......
.......@..@......@......@..@..
.....@.............@....@.....
.....@.....@.............@...@
......@.......@....@..........
.@.....@...@..@.....@...@@....
................@.............
@.@.............@.@.....@.@..@
............................@.
..............................
.......................@......
..............@......@....@...
....................@.....@...
..@.........@.@...........@...
...................@.@......@.
..@.........................@.
.......@.............@........
..............@..@....@..@....
..@.@.........................
@.@................@.........@
......@...........@.@........@
....@@......@.@......@........
.....@........@..@.....@......
...................@..........
