30,30
.......@......................
@............@................
.............@@..@............
......@....@........@.........
....@@.............@..........
.........@...@..@.@..@........
.@...........@................
........@.........@...........
..@.................@........@
@.@....@..@.@.....@......@....
......@.@...@.................
....................@.........
............@......@..@...@...
.....@@...........@......@..@.
........@..@........@..@@.....
......@@.....@@...............
..............@........@......
...@..................@......@
............@.@..........@....
.................@............
...........@@........@........
..........@............@......
.....................@.@.@..@.
......@.......................
......@..........@............
....@@.........@...........@..
....@@.@..........@...........
.............@................
.......................@..@...
...@......@.@..........@.....@
