30,30
............@...........@.....
..@....@...@......@..@.....@..
...........@..................
.......@....@.........@.......
..............................
..........@...@..........@..@.
...............@@@...@.@.@....
.@............................
..@......@..@.................
..........@.....@.....@.......
.........@.@.@@........@.....@
...@.........@................
......................@.......
...@...........@..@.......@@@.
...@..........@.@......@......
..@@...@...@........@.........
.....@........................
........@@.@............@..@..
............@...............@.
@..@.........@..............@.
..............................
.............................@
........@..........@..........
.@@.....................@.@.@.
..............................
.@................@..@@.......
..................@.@.........
@........@....................
.........@.@..@.......@.......
...@@@................@......@
