30,30
....@....@@......@@........@..
.........@.........@...@...@..
...@...........@...@.....@....
............@......@.......@..
.@....@......@..@.....@@......
....@..@.................@....
..@.....................@.....
...............@........@.....
.@...........@................
.............@.@......@.......
..........@..@.....@@.........
.................@..........@.
.................@..@.........
.@.@..@.......@....@@...@.....
...@.@.@...................@..
............@......@..........
.........@.........@......@...
..........@.@..@..............
........@........@......@.....
........@............@........
..............................
.........@................@...
.............................@
...................@@.........
..@..................@........
.@........@.........@........@
............@........@...@....
.....@...@.....@..@.@.........
....@...............@....@....
..@...........................
