30,30
..............................
...@.......@........@.......@@
............@........@........
..............@...............
..@.......@........@...@......
..................@.....@.....
.......@.........@@.......@...
...@..........................
.........................@....
............@.@.@........@....
@.............................
.......@....@.@.@@....@..@@...
.................@@@..........
.@.........@...@..@...........
..............@......@.......@
......................@@..@...
@...@......@@......@.........@
.@....@.....@@.....@...@..@..@
..@.........@.................
..............................
.....@.......@......@...@.....
........@.....................
..........@.....@...@@........
.........@@...................
....@.........................
...........@.................@
@.......@....@.............@.@
.........@............@......@
.............@.....@@.@.......
..........@......@............
