30,30
............@.....@...........
..................@.@.@.......
....................@.....@..@
.............@@...........@..@
................@..@..........
@........@.....@.@............
.....@........................
...@..........@...............
.......@.........@.......@....
..@.@.......................@.
.@.@..@....@......@......@....
......@..............@..@.....
.................@............
..............................
@................@............
.....@............@.........@.
.....@...........@....@.....@.
@.......@.@...................
..@.........@..@...@.......@..
..............................
..............................
.@..@...........@.........@@..
..........@...................
....@.@@......@....@..........
...................@@@@.......
....@........@...@@@@........@
.................@...@....@...
..........@..@.@@.@...........
....@.......@.........@@......
........@................@....
