30,30
.@.@...@..........@.....@.....
........@........@............
.........@.........@..........
.............@.@...@..........
.....@.@......@........@....@.
.@..@.........................
...@...@.....@..@..@.@.....@..
.@...........................@
....@.......@.................
..@...........................
.....@.....@..................
.......................@......
.@@...@...........@.@.........
.........................@....
........@.....................
@.........@.@.............@...
...@...............@..........
....................@.........
..@@.@......@@.@.@...........@
.@.....@.........@..@.........
...........................@@.
@.............@..@@.....@..@..
@...........@.@...............
........@.............@.......
.......@.........@............
..........@...................
@.@................@.@........
..........@.@.......@.........
.@.@........@.................
.......@.@..@..........@......
