30,30
...@..........................
........@...................@.
@.....@...............@.......
..........@...................
................@.........@...
.........................@....
..@............@...@..........
.........@........@........@..
....@..@.@....................
...............@..............
.@....@..@.....@..............
@.........@............@......
...........@...@..............
......@@......................
.......@.........@.@......@.@.
....@........................@
..............................
....@..@..........@.......@...
........@@.....@........@.....
........@..@@.@.@.............
..@..@.@..@......@..@.@.@..@..
.....@...@......@........@....
.........@..@...............@.
.............................@
.@@.....@.............@.@.....
...@....@......@.@............
.....@.....................@.@
.@.........@..........@....@..
.........................@...@
.@......@..@.......@..........
