30,30
..@................@@.........
....@..................@......
..........@@.........@....@...
............@@..@.@..@........
...@...................@......
..................@...........
.@....@.....@.........@.@.....
..@....@........@.............
.......@.@...............@..@.
...........@...........@......
................@...@.........
........................@.....
.......@.....................@
.@.................@.@....@..@
@......................@....@.
....................@.........
..@..@@@.@.....@......@.......
.@..@...@.@...................
...............@..............
...........@...@..............
........................@.@@..
.....@.....@.............@...@
@.......@.@.@@.........@......
...@.....@......@.......@.....
..........@..........@........
..@..........@....@@..@.......
................@.............
.............@....@........@..
..............................
.@......@..............@......
