30,30
......@.@..@..................
........@@..@..........@......
@@.........@...@......@.......
...@..@..@.........@....@.@...
..@.............@..@@..@..@...
.....@........................
........................@.....
..........@...@....@..........
................@.............
.@..@.............@..@.@....@.
...............@...........@..
.................@............
..........@...............@...
@....@.@..........@...@.......
...........@.@................
@....@....@......@............
.@...........@.@..............
........................@.....
.................@....@@.....@
.................@............
..............................
......................@.......
...........@..................
.........@............@...@...
.....................@.......@
.............@..@.........@@@.
..@....@.....@....@....@@.....
@...@...........@@.....@.....@
..............................
...@..@@............@..@......
