30,30
...@.@@.......................
........@......@.@..........@@
.................@............
@..........@.........@..@@...@
.......@....@@...........@....
.............@....@...........
.@@................@@.@......@
.@.@........@.................
...............@.@............
.....................@........
..@...............@.........@.
......@..................@@@..
..................@...........
..........@.@@...........@....
.@.................@..........
@.............................
..............@.@.............
.@.@............@...@.@.......
......................@.@.....
..@..@@.........@.............
.@...........................@
.............@.@.......@......
......@.....@.................
.@@....................@.....@
........................@.....
...@...@....@@.@.@......@.....
...@..........................
.@.....................@......
...@......@....@.............@
.....@@..@....................
