30,30
..................@......@.@..
.....@.....@...@..............
.............................@
......@.......@............@..
.............................@
.......@.......@.@...@....@...
..@.......@.....@...........@.
......@.......@...............
...............@.@............
................@........@....
@.@.@.......@.@@....@..@......
.@............@............@..
.....@.....@.........@........
.....................@...@....
......@.....@...........@.....
...................@.@........
.....@........@..@............
@.............................
..@..............@..........@@
@.............................
.......@@...........@.@.......
................@.............
...@..............@...@...@..@
.@@...@........@..@..@........
.....@..............@.......@.
............@.@....@..........
...........................@..
.....@.........@..............
...@.......@.@@............@..
@...@.@.........@.............
