30,30
....@................@........
..............................
........@......@......@.......
........@....@....@...........
@.........@........@..........
.....................@.....@..
........@.........@.....@.@...
....@...@..@.@................
......@...@...................
..@..@....@...@........@......
.....@@......................@
.......@....@.......@........@
..............@...........@...
@......@..................@...
@...@@@....@..................
.@.....@................@...@.
...@.@......@.........@.....@.
....................@@........
....@@.....@..................
........@................@..@.
.....@..@.....................
@@.@..@.......................
..................@.........@.
..............................
..................@....@.....@
........@........@............
..@.........@..........@......
@....@@..@.@.............@....
......@.@.......@.............
......@.@..............@......
