30,30
..........@.........@.........
................@@@...........
....@..@.............@....@.@.
....@.......@.............@@.@
..@.......@.@.................
................@@...........@
...@.....................@....
@............................@
....@.......@...@.........@@..
..........@@..@...............
......@.................@..@..
......@@.@@...............@.@.
..@..@........................
....@@...@.........@..........
.................@.@..........
..........@....@@@@....@...@..
...........................@..
.......@..@..........@@...@...
.@...................@........
..............................
...@...............@..@.......
....@................@........
..........@...................
........@..@..................
.@..@......@....@.............
....@.....................@...
....................@.........
@.....@.........@.......@.....
..............................
..@..........@.@@.@.......@...
