30,30
.@.......@...@..@.@.@.........
.....@..@............@..@....@
...............@..............
..@.............@....@........
........@..@..@..@.@.....@@...
..........@...................
@.............................
@....@.......@..@.............
.......@..........@@..@.@.....
.....@........................
..@...........................
.........@@@....@@.........@@.
................@..@.........@
............@..............@..
...........@.@.............@..
...@@.........@......@..@.....
.....@......................@.
..............................
............@..@.........@....
................@..........@..
..............................
.@........@.....@.............
...............@............@.
@...@.....@......@....@.@.@.@.
....@........@...@....@.......
...........@.....@............
............@.................
.........@.........@.@........
.................@.@.........@
..............@.........@.....
