30,30
...@.................@..@.....
......@...@...........@.......
..................@..@........
@..........@..............@...
..............................
...............@..............
...........@..........@.......
..@....@@....@.....@....@.....
........@..................@..
......@........@.@...........@
.......@........@..........@.@
@...........@....@............
.......@....@@..........@....@
.@....@...@...........@.......
.............@@@.......@......
...........................@..
.....@....@.........@.@......@
.@..@...............@.@@...@..
............@@.....@..@....@..
....................@.........
.@@...@.@..........@..........
..........@...................
.....................@........
....@.........@@.............@
..................@.........@.
...@@......@..........@.......
..@........@..........@.......
@..........@..@...............
................@..........@..
..............@...............
