30,30
.........@..................@.
.....@......@..........@...@..
@...@..........@..............
.@...............@.....@...@..
.............@.......@@.......
...@....@..................@@.
................@.....@.@.....
..@@.@...............@........
.........@.........@..........
.@............................
....@.....@............@......
........@@..................@.
....@........@.@..@...........
.@........@...................
.........@.@....@.....@.......
...........................@..
..............................
...@.....................@....
...@.........@...........@....
......@.......................
....@..............@...@@.....
....@...@.@.@..........@......
..@@...@......................
..@.....@..@..................
@@...@...................@@...
..............@.......@.@.....
..@.............@...@........@
@.....@...........@....@......
......@.....@.....@......@.@..
.................@............
