30,30
..........@......@..@..@......
....@.......@..@......@...@...
.......@@.@...................
@@............................
....@..................@......
....@......@........@.........
................@..@.....@....
.....@..@...@.@@..............
@..@.@.....@..................
.............@.............@..
...@.@..@....@................
....@@.......@.....@..@.......
..@...........................
..............................
............@.................
.....@.......................@
...@.@........................
.@...@.....@........@.........
.....@...........@.@....@.....
.....@........................
........@............@........
...@..............@..........@
...................@.......@..
.@..@@..@...@.................
@...@.......@.................
...........@.......@....@.....
......@........@@.....@.......
.@.......@@................@..
.....@.@..............@..@....
.........@..@.....@...........
