30,30
...............@..............
.............@..@@....@......@
.........................@....
.@...@......@@......@.....@...
..............@...............
.............................@
..............................
...@@......@...@.........@....
................@........@....
....@..@..@.@..........@.....@
...@@...................@@....
....................@.........
........@.@............@.@....
.@.........@@..@.............@
.......................@......
.........@......@.............
..@....................@...@@.
......@.....@.................
...@.......@.......@....@.....
........@....@......@.@.......
..............................
...@.......@@.................
............@....@@@.....@@@..
..............@......@.@......
.@@.................@.....@...
.@.......@....................
..@.......@............@.@....
.......@...........@.@.....@..
..............................
...@......@@......@...........
