30,30
..................@...........
.........................@...@
.......@@..........@.........@
.@@.............@.............
@...@.........................
..@.........@.............@...
..@.....@.@...................
.@.....@.....@................
.....@..@......@....@.........
.@........@@.@.....@..........
......................@.......
.........................@....
.......@.@...@@..............@
.........@..........@...@.....
.........@.......@....@.......
..............................
.........@.@...@......@.....@.
.@...............@......@....@
......@.........@.......@.....
......@...@....@..............
@.............................
.....@....@...................
..@..@.........@..........@...
.....@...@..................@.
............@..@...........@@.
...@.................@.....@..
.....@..........@......@......
..@..........@@......@........
......@.......@..@..@.........
@.@.........@...............@.
