30,30
.@.................@..........
..........@...................
.@....@...........@@..........
..@...........@...............
@..@...........@..............
....@...@...@@....@....@.@.@@.
....@@....................@...
........@.....................
...@.......@......@.......@.@.
......@.........@............@
........@..@..........@.......
..............................
.@.....@.......@..@....@......
....................@.........
.........@........@....@......
.......@@@..............@.....
......@...........@........@..
............@...............@.
.......................@.@....
@@..........@.@....@..........
.@.....@..................@...
...........@....@.........@...
@......@..........@.....@.....
.......@........@.............
.....@........................
...@..................@.......
..@.@.........@............@..
..@..................@........
..@.............@..@....@.....
@@......................@...@.
