30,30
@.............@......@.@......
..............................
...@...........@.......@....@.
..........@...................
.@...........@.....@..........
.....@........@...............
..........@................@..
.......@.@........@@..........
........@@..................@.
.................@........@...
...........@.@........@.....@.
...............@.@.........@..
........@...................@@
@.............@@...@.......@.@
....................@........@
.........@....................
...@..@.@..................@.@
.......................@......
........@@........@....@......
.@.@..........................
.......@@..........@....@.....
......@..........@.@...@....@.
...@.@.....@....@.@...........
..@.@.....@.@.................
.............@.@..............
.@..@........@..@...@....@....
.@.........@.............@....
.........................@....
................@..........@..
........................@..@..
