30,30
...............@.@............
.........................@....
........@.........@...........
..............................
...@...@@..................@..
...@.....@....@...@..........@
.@@...................@.......
@@.@@.........................
@..@...................@......
@...@.........@.............@.
....@...@@.......@............
......@...............@.......
.@.........@......@......@@...
.@............@....@.@........
..@@.............@@@....@..@.@
............@........@@.......
........................@..@@.
..............................
..@...........@....@@@..@...@.
............@.................
..........@...................
..@....@......................
......@......@......@.........
.............................@
.....@.....@....@@....@....@..
.....@................@......@
....@.........................
..........@.@......@..........
...............@.......@......
....@........@.....@..........
