30,30
..........@................@..
....@.@......@........@@@.....
...................@@......@..
...................@.......@..
.............@....@....@......
............................@.
...................@..........
..@@......@........@........@.
........@.........@...@.......
............@......@......@.@.
...............@.@............
@...............@.............
....@........................@
.............@...@..@....@....
.....@@......@................
.......@.@....................
..............@.............@@
...........@.............@....
....................@....@....
..@......@...@................
.@............@.....@.......@.
.@..........@..@..........@...
.....@...@@.............@.....
..............@@.....@........
@......@....................@.
...........@.......@..........
@..@.@.....@..................
...........................@..
.........@@@@....@............
....@.....@...........@.@.@...
