30,30
.....................@........
....................@..@.....@
.......@....................@.
.......................@......
...........@..................
.....@.......................@
@.........@.............@.....
..........@.@.@...@@..........
..@......@..@..@.......@......
......@.......@....@..........
..@..........@...@.....@@....@
..@......@...@................
............................@.
......@@...@@............@....
...........@.......@.@@.......
..........@................@..
.@........@...@........@....@.
........@.....................
..@.........@...@.@......@..@.
....@....@.........@@.........
.............................@
...@.@....................@@.@
...@.................@.@......
....@.........................
@..@....@.........@.....@.....
...@....................@.....
....................@........@
....@.@.........@.........@...
.............................@
.....@...............@....@...
