30,30
........@....@.@....@@......@.
..............................
.................@............
....@.....@......@@.........@.
........@...@......@......@...
..@..............@.......@....
.@............@..........@....
.@............................
..@.....@.....@.........@.....
....@..................@......
......@@......................
....@...@...........@....@....
....@..@......@...@...........
............@........@........
..........@...................
...@........................@.
.............@......@.@.......
.....@.......@.......@.@....@@
@.@.@.........................
@........................@....
.........@...@@.....@.....@...
...@.@...@........@...........
...@.@............@...........
............@.................
.@.................@....@.....
....@....@....................
....@..................@@..@..
.@...............@....@...@..@
.......@...........@@..@......
.............................@
