30,30
.......................@.@.@..
.............@....@..@........
..............................
.@.....................@....@.
.......................@@.....
@.@....@.................@....
..........@...................
...@...............@..........
....@@.......@@...............
.................@........@@..
...@.@.......@.@..............
@......@......@.........@.....
.@.........@...@..@........@..
...@..........................
...........................@..
...............@..............
..................@...@.......
..................@...........
.........@..@.................
.@.....@.............@........
...@......@........@......@...
....@....@..@...@...@......@..
.@.@.....................@..@.
........@@.......@.......@...@
.@.........@.@.....@.......@..
.......@@..@.....@....@.@....@
.................@.....@......
........@...............@.....
@@........@............@......
..............@.............@.
