30,30
...@.....@........@........@..
............@...@........@.@..
.@..@........@................
@..@..........@..@............
.........@....................
.............................@
....@......@..................
..............................
@...@...@..@................@.
.@..@.@...................@@..
.....................@......@.
.....................@@.......
...@.........@................
.............@@.@.....@.......
.......@..@..@....@...........
................@.............
.....@...@...........@........
................@@.....@......
............@..@.....@@.@.....
..@...........................
..@..........@................
..@...........................
....@......@......@...........
..........@...................
.......@.......@.......@@.....
..@@..........@....@......@...
...@.........@......@.@...@.@.
@.......@@@...................
.........................@..@.
....@........@@@.........@.@..
