30,30
.....@.........@@.............
.....@......@......@....@.....
.......@....@..........@.....@
................@..@...@......
...........@.....@............
.......................@......
..............................
...............@@....@........
.........@..@................@
.................@............
..........@........@..@......@
..@............@...@.........@
....@.@.......................
...@.............@.@..........
............@.......@.........
.@@@@..............@...@......
............@.......@@........
..@.@.........................
....@.............@...........
.@.....@..............@.......
......@..........@............
@........@.................@..
..@..........@...@............
@..........@.@.......@....@...
@........................@....
........@................@....
.@.......@.............@@....@
...@@........@...........@....
...........@..........@......@
..@..................@...@@.@@
