30,30
....@....@@@..................
...@..............@..@@@......
......@..@...@..@.............
..............@...@......@....
.@.........@..................
......................@......@
....................@..@......
............................@.
...........@................@.
....@.........@...........@...
......@@@@.@.........@........
.@.............@@...@........@
.@............................
.@@.......@......@..@...@.....
.............@................
...........@........@.........
.....@........................
..@....@.@......@......@..@.@.
......@....@........@...@....@
..@...............@...........
....@@.......@.......@@.......
..............@..@............
......@.......................
...............@...@..@.......
........@...@.................
.@..@...@.....................
...........@...........@......
...................@.@.@..@...
..........@..@..........@.....
.....................@........
