30,30
..@.....@.............@.......
..@.....@.....................
.@.........@@.............@...
.@....@.......................
....@....@..............@.....
@....@...@...........@........
......@..@.@.............@....
@..@@......@..@.@.@...........
......@............@........@@
.....@........@...............
.....@.........@...........@.@
..@.............@.@...........
...................@..@..@....
..........@.........@@........
...@.@........................
..@...............@...@.......
...@..........@...@.......@...
.@.....@...........@......@...
.................@............
.............................@
........@.....@..@.........@..
...@..................@......@
...........................@..
....@........@......@.........
.................@.....@......
@@........@.........@@...@....
........@@....................
......@....................@..
...................@..........
..........@.......@.......@...
