30,30
.............@.@..............
.@..........@........@.@.@....
....@.........@@..............
......................@.......
.@...@.....@@.................
..............@.....@@...@..@.
....@.......................@.
@.......@.....................
.@@@.....@@.........@.....@@..
............................@.
.....@....@...........@.......
.......@................@.@...
..................@.....@.@...
.@.....................@..@...
.....................@........
..@.........@......@.@..@.....
..............................
........@.....@....@..........
.....@........................
..........@............@......
...@...................@...@@@
........@@.........@....@.....
@...........@.................
..........@........@..........
...@.........@@...............
....@..@.@.@..................
.....@....@....@..........@...
...@...............@.......@..
.......@..@...........@.......
....@.@.............@.........
