30,30
@.................@....@..@...
.......@......@..@.@..........
....................@.....@..@
....@@..............@.........
.......@.............@@.......
................@......@......
.@.@....@....@................
......@.......@.@.............
...............@......@....@..
....@.........................
..............@........@......
..@...............@...........
..@...@@......@...............
..@..........@........@.@.....
........@.@..@...........@..@.
@@...@....@.............@.@...
........@@@...........@.......
...@...............@@.......@.
@......@@@......@...........@.
.......@..@.....@.....@.......
.....................@........
........@.....@...............
..............................
...................@..@@....@.
............@....@.@.@........
..@@..........................
..........@...................
...............@@.............
....@.....@...................
................@.............
