30,30
........@....@..........@.....
.@.....@....@....@..@@........
..............................
...................@@......@@.
.@.........@........@.........
........@........@.....@.....@
........................@.....
......@@.....@.......@@.......
.@.................@..........
...............@..............
.........@...........@........
...@..@.....@...@.............
..@...........................
..@...........................
.............@@........@......
...@..........................
..............@..@.....@.@...@
........@@.......@...@..@.....
...@...@................@.....
................@.....@.......
.........@....................
.................@........@...
.@....@...@........@....@.....
..............................
@...............@.............
....@..@@....@...@@.....@.....
.....@.............@........@.
@.....@@....@.@..@..@.........
...@@..@@.....................
.@......@...............@.....
