30,30
........@................@....
.................@...........@
..................@......@....
....@.......@...@.............
.@............................
....@.....@...................
....@@.......@................
.....................@......@.
...@...........@....@.@.@.....
....@....@....................
.......@....@......@@..@....@.
....@......@.....@............
.......@....@.....@.....@.....
..@@..@...@...................
...@..........@.......@@......
...........@......@.....@.....
.......@........@...@.......@.
.............................@
...@.@................@.......
....@..................@......
...................@....@.....
......@............@.......@..
...........................@..
..@............@......@.@.....
............@......@@......@@@
.........@....@@....@.@@@.....
...@.............@.......@....
...........@........@@........
............@.............@...
.@............................
