30,30
..@..@@..................@....
@...@.@.......................
..@........@........@...@.....
.......@......................
......@........@.....@........
..@...............@...........
@.@.....@.......@..@..........
.......@.......@..@@......@...
...@.....@................@...
..........@.............@.....
.......@..............@.......
...........@....@.......@.....
......@......@...........@....
.....@..@..................@..
.....@....@.@.@.@.....@...@...
..............................
...@...........@...@.@@.......
@........@..@...........@..@..
..........@...@...............
.......................@......
...........@..................
....@...............@....@....
@........@......@..@........@.
..............................
............@.......@...@.....
...........@..............@@..
.......@.......@@..........@..
.......@...@.@................
.........................@....
..@..@..................@...@.
