30,30
.......@@.........@...........
.........@@.@.@.........@.....
....@@........@@...@.........@
...........@@...@.............
....@.......................@.
..............@...............
..........@.......@@.....@@...
..@...........................
...@.@.....@@@@.@......@..@...
.............@.............@..
........@.....@..@............
.............@.......@.....@..
..................@...........
.....@.................@...@..
.......@......................
...........@..................
.........................@@.@.
..............................
@.........@................@@.
...@..@.......@.....@.........
..............................
...........@@...............@.
..@@...................@.@...@
.......@......@....@@.........
......@.@...............@.....
..............................
...@.....@..............@@....
.......@..............@.......
.................@@..@........
@.......@..@........@@....@...
