30,30
....@.......................@.
......@...@...@..@............
..................@.........@.
..@...........................
@..@.....................@....
.......@.........@............
@................@...@........
.@.....................@......
...........@........@.@.......
.@........@...................
.........@.@......@...........
..............@@..............
........@.....@...........@...
..........@...@......@........
...@.............@..@.........
..........................@..@
................@.......@.....
@@.............@@@...........@
.........@.......@....@.......
....@...........@.............
.......@.......@.....@.@......
........@.....................
.......@...........@@.@.....@.
@.......@.....@.......@.....@.
.@.@..@.@..................@@.
.....@..................@@....
........@.........@...........
........@@..@..@......@.......
......@..............@........
.......@....@...@.........@...
