30,30
..........@@........@@........
@...@.@.....@......@...@@.@..@
..@..@........@..@...@........
.........................@....
..@...........................
.@...@..........@...@.........
............@..............@..
................@.............
..........@.....@..........@..
.......@..........@...@.......
......@.......................
....@.........@.@...@.........
...................@..........
..........@@........@.........
....@........@..@............@
..........@.......@....@.@....
...........@...@..@.....@.....
..............................
..........@.......@@@.........
.....@........................
.........@.............@......
..........@..................@
..........@..@....@...........
....@..@.....@...@............
@@.....@......@..@.....@......
@..................@@...@.....
@....@..........@.............
....@.........................
........@........@............
...........@...@.@..@.........
