30,30
.@...@........@......@.@......
.....@....@......@............
..........................@.@.
..............@.@........@....
.......@.@...........@........
......@...........@...........
@.@........@..@..........@.@..
@..................@..........
.............@.......@........
.@..@........@...@............
@@...........@........@.@.....
......@....@.........@.......@
.............................@
..@.@.........................
............@................@
.......@...@..................
............@.................
...................@.@...@....
....@........@...@........@...
.@.@...........@@...@@........
........@.................@@..
.....@.....@..................
.@......@......@........@.....
@.@..........@.....@.........@
......@...................@...
@.........@.........@.........
..............................
.....@.....@............@.....
@....@....@...................
..............@.......@..@....
