30,30
.......@.@@....@............@.
..........@....@.......@......
...........@..................
..@..............@............
...............@@...@.....@.@.
...........@.@................
.................@............
...........@..................
.......@..........@.........@.
..............................
..@.@@..........@.............
..............................
..@........@............@.....
@@@....@@...........@........@
........@....@.....@@..@.....@
.@.....@...@..................
@.............@..........@@...
...@...@....@...@.........@..@
.............@....@...........
...........@............@.....
........@.............@.......
.......@........@..@....@.....
...............@..............
..................@..@........
.........@........@........@@.
....@...@.....@..........@....
..@.@......@...@.......@......
.......@..@............@.....@
.....................@........
..@.....@.......@.............
