30,30
.........@...@.@......@.......
.........@....................
.............................@
..........@.........@......@..
.@...@@..@............@.......
......@...@......@@.........@.
.......@.............@..@..@..
@...@...............@.........
......@.......................
..@.............@.@........@..
......@.......................
..@.............@.............
...@@........................@
............@...........@.....
.....@.@......................
.....@....@......@............
..........@.....@..@..........
@....................@.@@.....
......................@..@....
@.......@...@........@........
..............................
@.........@........@@.........
............@.@.......@..@....
......@@........@...@.......@.
...@........@.........@.......
..@...................@@......
............@@........@.@....@
.......@@@....................
.......@.......@...@....@.....
............@................@
