30,30
.................@.......@@@..
..@.....@.......@@.@........@.
.....@....@...................
.............................@
.........@..............@.....
.............@......@.........
@...@@............@...........
..@...........@............@..
.....@......@.........@.......
...........@..................
@.............@.............@.
.....@.@...................@..
...........@...@...@..........
@........................@.@@.
............@....@............
.......@..............@.......
@...@............@.......@..@.
..@@.....@.........@....@.....
.....@.............@..........
@.............................
...........@..................
..............................
.......@.........@...@.....@@.
@........@........@......@....
..........@.....@............@
...@..@...@......@....@.....@.
............@.....@...........
@@.@.@......@................@
@...@.........................
@...@........@................
