30,30
@..............@.....@...@....
.........@....................
..........@.....@......@......
..@...........@..@............
.@...@................@....@..
....................@@@.......
@@..@..........@..............
....@..@.......@.@............
.....................@........
............@..@..@........@@.
........@....................@
@.......@.....................
..@.....@...............@.....
..................@.......@...
....@........@@.@..@....@..@..
.......@..@...@...............
......@............@..........
............@.............@...
@...............@........@....
...@........................@.
..@........@....@.........@.@.
@..@.@..@...@.....@...........
..............................
...@.......@.....@.....@......
................@..@..........
........@...............@.....
@....@........................
@.......@.....@...............
@.......@.....................
......@..........@..@....@....
