30,30
.......@.....@......@...@....@
@@..@....@....................
@.........................@...
...@....@.....................
..............................
...................@...@......
.......................@......
..@....@..@@..........@.......
@...@.@....@........@.@.......
..................@.........@.
.@........@...................
@.@@..............@....@...@..
............@....@....@.......
.@....@.@.@...@......@........
.........................@....
......@@......................
........@........@@.......@...
...........@....@.............
....@....................@....
..@...........................
..@................@..@.......
............@...............@.
....@..@..................@...
................@.............
....@@...@....................
..@....@.@.........@..........
...............@..........@.@.
...@.@....@.........@....@....
@.@.@......@....@.............
.......@........@..........@..
