30,30
.......................@@....@
...@@....@.@.............@..@.
......@.......................
.........@.......@..@.@.......
.......@....@@................
......@...............@.......
..@......@@............@......
.@.....@.@....@...............
......@.......................
.................@....@.......
......@..@..@..........@@...@.
...@..@...@...................
.@.@......................@.@.
.......@...@.......@..........
.........@.............@......
.@....@..@....................
..............@...............
.@..@.....@.........@.......@.
...........@.........@........
.............@.........@.@....
.....@....................@@..
.....@.............@..........
..@..@......@..........@@.....
...@..@.....@.............@...
..............................
................@.............
.........@..@...........@...@.
........@..@.........@........
.....@.....@......@.....@@..@.
..............................
