30,30
.....@...@...@.....@..........
..............................
......@...@......@............
..@..................@........
..............................
...........@.......@..........
......@......@................
....@......................@..
.............................@
..@@.@..@.@@.@.@.........@..@.
@.......@@......@.....@.......
.........@............@.......
.....@.@...@......@..@........
.....@@..............@........
.@..................@.........
......@.@...@.......@...@...@.
...@.@........................
......@.........@...@.........
...........@..................
......@....@..................
............@.................
.....@..@@........@...........
.@..@..............@.@.....@..
......@.......................
....@.....@.........@...@.@@..
......................@.@.....
@...@.........................
..@........@...........@@.....
......@.....@..@..............
@...@@.......@.@..............
