30,30
.@.@..........................
.....@..................@.....
...@................@....@....
.................@............
...........@.......@..........
..............................
@.@.@...........@....@........
..............................
..........@...@...@.@........@
.@....@.....@........@..@@....
.................@............
..........@...@....@.......@..
.@@.........@............@...@
............@.............@...
............@.....@...........
.......@..............@..@..@.
..@....@..@..@@......@........
............@.................
.........@........@...........
........@.........@......@....
@.......@....@................
@.................@.....@.....
...@........@............@@.@.
@...........@.........@..@....
.........@.@@.................
.....@....................@@..
....@...........@@............
.............@..............@.
..@.........@.................
.......@@.@..@...@...@........
