30,30
.................@..@.......@.
.....@.........@...@..........
...............@....@.........
@.....@..@........@..@........
................@.....@.......
.......@......................
...........@.............@....
..........@.............@.....
.....@.....@............@..@..
..@.@.....@.........@..@..@...
..............................
....@................@........
........@..............@....@.
@............@.....@..@....@..
......@.@.....@@..@...........
..............................
......@...................@...
.....@..........@.......@@....
.........@@...@............@.@
@@@....@......................
.@....@.......................
..................@..@@.....@.
..........@...@............@..
..........@.@..........@@.....
............@.........@.......
..@....@................@.....
...@....@..................@..
.......@......................
........@.......@..@.....@....
...@@.........@..........@....
