30,30
@@........@.@..@@.........@...
..@.............@.............
.@......................@.....
...............@...........@..
............@.........@@......
............@..@..........@...
@.....@...@............@@.....
..............................
.....................@........
@.........@..............@....
.@.......@@.....@.....@@......
...@.@...@@......@............
..............................
...........................@..
......@......@................
........@.....................
.........@.@.@..@..........@..
....@.........@.......@@......
........@...............@.@...
...@.@...................@.@..
..........@.....@..........@..
..@.............@..@...@......
......@..............@........
....@..........@@....@......@.
....@.............@.....@..@..
...............@@.......@.....
....@........@..............@.
.......@.@.@............@.....
...............@.......@......
...........@..................
