30,30
@...@@...@...........@........
.....@........@.....@.........
..............@.......@.......
........@.@........@.....@....
........@.....@.@...@.........
.........@..........@..@......
....................@.........
..@.@.............@...........
......@............@..........
@.....................@....@..
....@@...@....................
........@...........@.@..@....
................@@...@@.......
......................@..@....
@.......@.....................
.......@..........@...........
...........@..........@......@
...@.@....@........@.....@....
.....@@.....................@.
@.@...............@......@....
..............................
....@.......@@@...............
................@@....@...@.@.
.............@...........@....
...........................@..
...@.........@..@........@....
.@...@..............@.........
........@@......@.......@...@.
..@..@.....@..@...............
..............................
