30,30
........@..........@.....@....
..........@..@................
@...@.........@..@..........@.
........@..@...............@..
....@........................@
.@..............@....@........
........@.....@..........@....
...@........@.......@.....@...
........@.........@...........
..@........@...@..............
........@...@.................
.....@...@...@................
..@..........................@
..@................@.......@..
...@.....@@..@..............@.
..............................
...@........@....@........@...
..@..@......@...............@.
...................@..........
@............@...@......@.@...
@..@.........@............@...
.@.@.........@...@..@.........
..@.............@..@..........
.@................@.....@.@@..
..............@...@...........
..........@.......@...........
.@@........@....@.............
...........................@..
..@.......@...................
.@@.........@.................
