30,30
.......@........@.............
............@........@........
................@...@.........
....@.........................
.....@........@..........@....
....@.................@.....@.
................@...........@.
........................@.....
..............@...@...........
.............@...@..@@........
@.....@.@..................@..
..............................
@..@....@...@@....@...........
@.........@@..................
@@........@....@@.............
..........@.........@.@....@@.
.......@..........@..@....@...
...@...@.............@.......@
@............@...@......@.....
...........@.......@.........@
..............................
.....@.@..@.................@.
@..............@...........@@.
@......................@....@@
..@@...@......................
..........@.@........@........
......@.....@..@............@.
....@....@....................
................@.@...........
@@..........................@@
