30,30
..@...................@.......
.@.@@.........................
..................@...........
.....@....@..@@.........@.....
..@.......@.......@...........
....@..........@....@@@.....@.
.......@.@@...................
......................@.......
.@.......@@.@....@....@.......
..@....................@.@....
...@..........................
..............@@.....@........
.....@....................@.@.
@.....................@.@...@.
..@@......@..@...@............
.........................@....
.............@.@..@....@..@@..
...@.......@@.................
.@.........@..................
....@.....@...............@...
@.......@..@................@.
............@...........@.....
...@..........................
......@....................@..
@..............@..............
....@....@....................
..@...@.........@.............
.........@......@.......@.....
@@....@............@....@.....
.............@..............@.
