30,30
...@..@.......@@.....@...@.@..
......................@.......
............@.................
........@...............@..@..
..@........@@@................
..................@.@....@@..@
.........@.......@............
....@.........................
...............@..............
.........@...@..@.............
...................@.@..@@....
.@.@..........@.@.............
....@.......@@...........@....
..........@....@.......@.....@
@..............@..@@.........@
..........@...................
.@......@....@................
..............................
....................@..@......
.@.@.@.............@..........
......@........@..@..@........
.@.@@.................@.......
.....@@....@.@...............@
....@.............@...........
........................@.@...
.......@..@.......@@.@....@.@.
...@..@...@.........@@@.......
..............@...............
..............................
..............................
