30,30
............................@.
.@.......@...@.......@..@..@..
.......@@.....................
@......@........@.@...........
.................@...@...@...@
@..@..........................
...@..........................
....@.........................
.......@.......@....@.........
........@..............@......
......@......@........@.......
........@.....@.........@.....
..@..@................@@......
..@.........@......@..........
...@..@......@.@...........@@.
..........................@..@
.........@.....@@.........@...
@.............@...@.........@.
................@......@....@.
.............@@.@....@..@@....
...................@@@......@.
..............................
..............................
..@@.@....@@..................
.....@........................
..@.................@......@@.
................@.@...........
.@....@.....@..............@..
........@..@.@................
...............@..@..@........
