30,30
.@......@.......@...........@.
...............@........@...@.
@..@@.........@......@........
.....@...@@...................
@.@...@@......@...@.....@...@.
......@@...@............@..@..
@...........@.@@..............
.@..............@........@....
..............................
......@..................@@..@
....@.......@.................
@.@...............@..@........
@..@.@..........@.........@...
.................@@.@......@..
.....@@..................@....
....................@.......@.
.............................@
..............@....@.@.......@
...........@..................
...@...@......................
............@................@
................@.............
..........@....@..............
.........@@..................@
....@..................@@.....
...............@....@.........
....@..............@..........
...........................@..
........@...........@......@..
....@..........@@...........@.
