30,30
.............@................
......@.@....@......@.........
.@...................@....@.@.
.............@..@@....@.......
.@....@.......@...@....@......
...........@...@......@.......
.......@.............@........
.....@@.@.....................
....@.........................
................@...@.........
..............@...............
..................@...........
.........@@............@......
...@...@..........@@....@.....
.......@...........@..........
..@.@..............@......@...
.......@...................@..
.......@....@.....@..@........
...@@.........................
.......@.............@.@..@...
..@........@.@.....@..........
......@.................@.....
...@..........@......@.@......
.....@................@@......
...@...............@....@.....
........................@.....
....@.........@.......@......@
......@...@..@.............@..
......@.@......@..............
........@....@...@.@.@........
