30,30
@.@....@.....@............@...
...@.....................@....
.....@..@.....@...............
..................@...........
...................@......@...
..........@.................@.
..@...@................@......
.................@.......@@...
.......................@..@...
.............@...........@....
....@................@........
.......@..@.........@.@...@...
@..@...@@.....................
....@.@...@..@@...............
......@@...........@..........
..............................
......@.............@.......@.
.................@............
.@@...........................
........@...@.........@@......
......@.....@.@...@.....@..@..
..@@.........@..@............@
.@.....@.@..@...............@.
..................@......@....
.....................@........
..............................
.....@.....@....@...@....@@.@.
.......@.....@.....@@@..@@....
......@............@..........
.............@................
