30,30
.@..........................@@
......@.......@..@............
.@.@....@...@...@...@.@....@..
..@..@.............@....@.....
..@................@..........
......@......@................
...................@..........
.....@..............@......@.@
..@......@....@...............
.@...............@...@.......@
...@...@.@...................@
@.......................@@....
............@@.@..@..@...@....
.....@....@@..............@...
...@..........@@.............@
...................@..........
@....@....................@...
...@...............@........@.
..................@...........
......@.......@...............
........@@........@...........
.......@..@...................
..........@..........@...@....
......@..........@@.....@....@
..............................
.@.........................@..
........@.....@....@..........
....@.......................@.
..........................@.@.
....@......@...@..............
