30,30
....@..@......................
........@.................@@..
..................@...........
..........@.............@.....
.@........@.@..@..@....@......
....................@.........
..............................
....................@.........
......@......@..@.............
........................@@..@.
....@...@.....................
.......@..@...@..@...@....@...
.@....@...........@.@....@@..@
@.............................
.....................@@.......
@........@.@......@...........
@.............................
...@..........................
.........@.............@......
..@.........@.@...@@..........
@.......@@.........@@....@....
@...............@.............
.....@.................@......
@................@..@......@@.
..@.....................@.....
...........................@..
..............................
...@...@..@..@..@@.....@...@@.
......@.....@.@......@.@.....@
......@.......@.....@........@
