30,30
......................@.@....@
..@...@....................@..
.................@............
...........@..................
@.........@...................
.....@..@.@.@...............@.
.....................@........
...@.....@@........@..........
.........@....@.....@.........
..........@................@..
...@@.@....@.............@....
....@.........................
...@............@.............
@.......@@...@..@@...@........
.@....................@.......
..@...@............@..........
.@@...@...@...............@...
.......@......................
.....@.......@................
..@....@...@@......@@.@.......
...@........@.......@@..@.....
....................@.........
..@..@.....@......@....@....@.
....@...................@.....
.@....@......................@
....@.......@.@..@..@......@..
........@...................@.
.................@@...........
..............................
.........@.............@..@...
