30,30
...@....@.....................
...................@..........
...@......@........@........@.
.............@...@...........@
............@............@@...
.....@...@....@..@.@..........
.............................@
.........@@............@......
.....@.....@...@......@.......
..............@...............
......@.....................@.
......@......@...@..@.........
.@............@...............
...@....@...@.@...@@...@......
........@............@....@...
.........@...........@........
.........@.@.@@...............
....@..@.@....@...............
.......@....@.................
.....@....@......@....@.......
....................@.........
....................@.........
...@.........@........@.....@.
.........@.@.........@......@.
.......@....@.@...............
.......@@........@...........@
.........................@...@
@..@..................@@....@.
......@......@................
..@.@..........@..............
