30,30
..@............@.....@.....@@.
..............@@..............
..@..........................@
............@.............@...
..@@......@...................
..............................
...@..............@.@....@....
.........@..............@.....
.......................@......
..........@......@......@.@@..
...........................@..
..@..................@........
....@.@............@.@@@..@..@
......@...@.@.@...............
...@........@....@..........@.
.......@....@......@..........
...@..@...@............@.....@
@.............................
........@.....................
...........@..........@@.@....
@...............@..@@....@....
............@.................
.@...@@@......................
...................@..........
@.............................
@..@.....@.............@..@...
...@.@.....@.........@........
..............@..@..@...@.@...
....@.....................@...
..........@.........@....@....
