30,30
...@..........@..@..........@.
............@.................
....@...@............@......@.
.@.@....@..@@......@.@........
.................@..@..@......
.............@........@.......
.@...@.@.................@@.@@
@.............@.@.............
....@............@..........@.
..@.@............@....@.......
........@.......@.............
.............@......@........@
....@...........@......@......
.........@..........@.........
....@...@.....................
......@.....@........@........
........@...@..@..............
...@.@...@......@.............
.@......................@..@..
.......@............@@......@.
.......@........@.............
...@...........@...........@..
.........@...@.@...@..@.......
...@.@........................
..@@..@.......................
..............................
..............................
.@...@............@.........@.
..........................@...
.....@...@..........@.........
