30,30
..@..........@................
.......................@...@.@
@...........@.................
.@.......@......@.....@@....@.
......@......@................
.......@.....................@
...@..........................
..@.........@........@........
..@.@.........@.......@....@..
.............................@
.............@............@...
........@.@.......@..........@
....@.....@......@...@........
.............@................
..........@.........@......@..
.@....................@.@.@...
@@.@.@..@.....................
........@..@..................
.@.@..........@..@..........@.
................@....@.@......
...........@..................
.................@......@..@..
.................@...@....@...
@@@..........@...........@....
..@.......@..@.......@..@.....
..........@.............@....@
......@.......@....@..........
.....................@........
..............................
.....@..@....@.......@....@..@
