30,30
..............@@...@..........
..............@......@........
.....@..................@.....
........@.@@@........@........
@.@....................@......
.............@.....@.........@
.....@@.....@...........@@@.@.
...@..........................
..............................
...........@...........@@.....
..@...........................
.@@....@........@.............
..........@..@.............@..
........@.........@...........
....................@@.......@
..@..............@...@......@.
........@....@................
.........@.......@............
...@..@.@..@..............@...
....@....@.........@......@...
.........@...@..........@..@..
........@..........@...@.@....
...@.@.........@.......@......
.......@..........@...........
..@............@.......@......
......................@.......
@...............@.............
...........................@..
@............@..............@.
@..@..@......@@..@.......@....
