30,30
..............................
....@....................@@...
....@....@@........@..........
....@.@....@..................
.................@...@........
......................@.@..@..
..@..@.......@...............@
.@.........@.................@
..........@...@.........@.....
.@.....@..............@..@....
....@.....@...@@...........@..
...@.@........@..@.@....@.....
..@...........................
..........@...@...............
........@.@........@..........
......@..........@...@........
.....@@@......................
.@.@.....@....................
.................@.....@......
.......................@......
....................@.........
...............@........@.....
..........@......@............
.........@....................
..........@...................
...........@...@.......@.....@
....@.................@@......
...@.....@..@..@..@..@...@.@..
........@.....@...@@.....@....
@..@.@.........@......@.......
