30,30
..............@.........@.@...
.............................@
@.....@@@......@........@.....
.....................@........
..@..@...@...........@........
...@...................@......
....@......@.....@............
@........@...@.@..............
.@@...@......................@
.......................@..@...
........@...@.....@...@.......
...@..........................
.......@.....@..............@.
............@...@...@.........
.@.....@.....................@
.....................@........
@...@.........................
..@.@...@..@................@.
..@......@....@...............
.........................@@...
....@..@.....@..............@@
..........@........@.........@
.............................@
.@........@..@.@.@.......@@...
...@......@....@...@........@.
....@..@..................@...
@...............@............@
..............................
..@...@..@...@......@.........
...........................@..
