30,30
..............................
............@.......@..@..@.@.
@...@@.....@..................
......@..............@.@....@.
.....@..@............@......@.
....@............@.....@......
@.....@......@.@..@........@..
..................@@..........
.........@...................@
..............................
...@....@.....................
.@................@....@@.....
..@.....@@.@@.@...............
..@.....@..@..@....@..........
.....@.@.........@........@...
.....................@......@.
........@..@............@.....
..............................
@.....@..@....................
............@.............@...
..........@...@....@..@@......
..............................
.@.........................@..
........@.............@.......
.@@.@.............@.@..@.@....
..............@...............
..............................
......@...@....@......@.......
............@....@......@.@@@.
......................@....@..
