30,30
.@.........@..................
.....@................@...@@..
......................@....@..
.....@........................
....@................@........
....@...........@.@.....@.....
...@@..........@......@..@...@
............@.................
............@.@..@............
......@......@............@...
.........@.@..................
................@.............
.@@@.........@.@....@...@.....
..............................
.@............................
..@.......@@..................
.@..@................@.......@
...............@..@.........@.
...@.......@........@@........
...........@...............@..
@.........@.....@............@
.@.@..@.....@......@@.........
....................@.........
.................@.@.@@.@.....
..@..@.....@.................@
..@...........................
@....@........................
.@.@.@...@....@...............
.@...................@@.......
........@..@..........@.@.....
