30,30
..@@..@......................@
.......@....@@................
....@......................@.@
.......@......................
..............................
.........@....@@......@..@.@..
@.....@.......@............@.@
.............@..........@.....
..........................@...
@.................@@..@.......
...........@..............@...
....................@...@@....
...@........@.@.........@.....
.@............@@..............
....@.@............@....@.....
...@........@.................
.@............@.@.............
.@...@.@....@.......@......@.@
.........@......@.............
.............@.........@.@....
............@..............@..
..@@.................@........
....@..............@..........
......@...........@.@......@..
..............................
........@.....................
...@@.@...............@....@@.
...........@....@.@...........
....@......@..................
......@@..@..............@.@..
