30,30
....@......@.........@........
.@..........@....@.@...@.@@...
@.....@.....@.........@...@...
@.....@.............@.........
......................@..@....
..........@..........@..@.....
...........@.........@@.......
................@.............
@.@...........................
........@......@..............
..@...........................
.@.@...@..@......@......@.....
.......@...........@..........
..............................
.....@.......@.......@..@.....
...@...........@.....@.@......
...@...@.......@..@...........
..@...........................
.............@........@.@.....
....@.........................
......@@..........@.........@.
............@..@@.............
@.............................
@......................@......
.....@....................@.@.
..............@...............
............@...@@............
...@...@........@.....@.@....@
@...@@.......@..............@.
....@...@@...@.........@......
