30,30
.............@.............@..
.........@.................@..
................@......@..@...
.......@.....@...@............
....@...................@.....
.......@....@.....@.@.........
..@......................@....
..@.......................@...
@..........@.@...........@....
..@...........@...............
............@..@.@............
........@.@@..........@.......
.@.......................@....
...@..........................
.......................@......
......@.....@...@..@..........
....@...@.........@...........
...@......@....@..............
.................@.........@..
..........@@...@......@......@
@.@....................@@.....
.......................@@@....
..@@.....@..@...@.@...........
@......@.@.@.....@......@.@@..
.........................@....
......@.@................@....
.........@........@...@.......
...........@..................
.......@......@@@.......@...@.
......@.......................
