30,30
....@........@..@.............
...@............@.............
.....@.......@................
....@..........@...@..........
......................@......@
@...@...@.....@...............
..........@...............@...
....................@..@......
...@.......@........@......@..
@......................@......
..@.@.........................
..........@......@.@..........
..........@...................
.@......@............@.@......
........@....@...@........@...
....@........................@
...@@..@...@.........@.@......
....@...............@......@..
.........@.....@.........@....
...............@...@@.........
.@..@........@@...@....@@.....
.......@......@.......@.......
.@..@............@............
..........@..@...............@
@.....@.............@.........
...@.....@....................
..........@....@..@.........@.
...........................@..
@...............@.............
...@.........@.....@..@.....@.
