30,30
.@.@.@@.@................@...@
.....@........................
............@.@............@..
@..........................@@@
....@..........@@......@@.....
.@...............@............
.....@.@......................
........@.........@...........
........................@.@...
........@...@.................
...............@..............
............@..@............@.
.@..@@............@..........@
..............@@......@.@...@@
..............................
..............@...........@...
.@.........@......@...........
.................@..@@.......@
..................@...@.......
.@.@.......@....@........@...@
.............................@
..@.@...@........@............
.........................@.@..
@........@....................
......@...@...@......@@@..@...
@.............................
.@.@.................@.....@..
.@.............@.....@.@......
......@.........@......@......
..............................
