30,30
.@......@...@.......@.........
...@.............@.....@......
......................@@..@..@
....@.........................
@....@@.......................
@.@.....................@.....
.@@@......................@...
.......................@......
.....@....@...........@@......
...@...............@..........
.@...............@..@@........
.......@.......@.......@...@..
............@.................
..................@...........
.....@....@.......@......@..@.
..............................
.@...........@.........@...@..
......@..........@..@..@......
..@...@.........@.............
..............................
..........@.....@....@.....@..
.......@....@..@@.....@.......
.......@......@........@......
............@.@@..............
@@..@......................@..
....@.......@............@....
.......@.@.@..................
.......@@.........@..........@
..@..@...@..................@.
..@......................@....
