30,30
.......@..............@.......
..........@...@..@..@.........
..........................@...
...@...@...@.........@.......@
.@.....................@.@....
...@@....@..@.....@...........
........@@....................
.............@...............@
...............@.@..@...@.....
.@@..............@...........@
.......@...@.................@
@........@........@@.@.......@
@..@................@.........
.......................@......
....@.@......................@
..........@.........@.......@.
.@...@.......@................
......@......@.......@......@.
.@............................
..........@@..................
@...........@...............@.
...@..@.......................
..............@........@......
..........@..........@..@.....
........@...@.................
...........@....@....@........
.....@.......@......@.......@@
..............................
......@..@@....@.......@@.....
...........@....@....@........
