30,30
@@.....@........@........@....
........@........@.@...@.@....
..........................@...
........@......@..............
.......@...........@..........
.......@......................
..@..............@.@..........
.....@....................@...
......@........@@...@.........
..........@.......@..........@
.....@......@@.............@.@
.......@............@.....@...
...........@.......@.......@..
............@.................
......@........@......@@......
.......@.............@........
....@....................@@...
..@............@.@.....@......
@...................@.....@.@@
.......@.....@.....@...@......
@....@.@......................
...............@@@............
..@....@.....@@..........@....
........@...@.................
...........................@..
..................@...@.......
.....@....@.......@...........
................@.........@..@
........@.....@..@.@....@.....
............................@.
