30,30
.....@.@..@@........@.........
....@................@........
.........@...@....@...........
..@..............@..........@@
...........@..@..@.....@..@...
..........................@...
..........@.........@...@.....
.....@........................
......................@....@..
.......@...@...@..@@@.........
.....@........@........@......
.@.............@.@............
@.@@....@.............@......@
.........@@.............@.....
...@.........@......@.........
..........@..@................
......................@.......
........@.................@@@.
..@.......@..........@....@...
...........................@..
.........@.@..@..@..........@.
@..........@.@....@@..........
.............@....@..........@
..............................
............@@.............@..
..........@......@...........@
................@.............
..............................
..@.............@@............
@...@....................@@@..
