30,30
.@...@..........@.............
...@@......@..........@...@...
@.............................
........@...@...............@.
..@...........@..@............
..@.........................@.
.@...@..@.....................
...@......@..@...@............
.........@@.@@................
.........@..................@.
..............................
................@......@......
..........@........@..........
.....@.@.....................@
.@@........@...@.......@....@.
............@...@@............
...@...@...........@.......@..
....@.........................
.........@.@..@@......@.......
..........@.@..@..............
.........@....@......@.@.@....
.........@....................
...@.........@.@.........@....
........@................@.@..
...........@..@.....@...@.....
@..@........@......@...@......
.......................@......
..@...@...........@...........
...........@...@..............
...........@...........@.....@
