30,30
.........................@.@.@
.............@..........@.....
.@@.........@...............@.
.........@.......@@@..........
.................@..@......@..
@..........@........@.@.......
.....@..@....@................
....@......@..................
...............@........@.....
.......@@.@....@.........@....
.......@...@.....@.........@..
...@@...@..@........@@.....@..
..............................
..............................
.@................@......@....
............@...............@.
..............@..@..@....@....
................@.............
..@..................@.@......
......@..@@...................
.........@.....@.....@......@.
.....@...@.........@.....@....
.......@....@.....@...........
................@.......@@....
..............................
@.........@............@...@..
..@..@..........@....@........
..@...........................
@..@.........@................
@...@..........@..........@.@.
