30,30
@.............................
.........@.......@............
.....@........@.....@......@@.
....@.........................
...............@...........@.@
.@........@...................
...@...................@....@.
.............@.@....@@........
.@.@....@......@............@.
@............@.@@@...........@
.....@......................@.
...@..............@.....@.....
..............................
.....@.....@...@......@.......
....@.....@...@.............@.
..........@......@......@....@
...........@......@....@@.....
......@.............@.........
.@.......@.........@..........
..............@...@.........@.
..@................@..........
.....@.......@.@..............
....@.@..@....................
..@............@..@...........
....@......@.....@........@...
...............@........@.@...
@......@....@........@...@....
...............@........@.....
.......................@......
..@@.....@....................
