30,30
.............@...........@....
........@...@...............@.
..@...................@...@...
......@.......................
@.@....@....@....@@@......@...
@...............@....@..@.....
...................@.......@..
.......@.......@..........@@..
.@...@........................
...@.....@....................
@.......................@.....
.......@...@.....@....@....@..
@.................@.@.@......@
..........@...................
@.....@.................@..@..
.....................@.....@..
.............................@
........@.@..............@@...
.........@...@...@............
@.................@.@......@..
.......@........@.......@....@
.....@....................@...
..............................
............@........@......@.
.................@...@.....@.@
.@..@.@............@.........@
.....@.......@................
.................@@.@@.....@..
...........@..................
..@........@..................
