30,30
...........@...........@......
.........@..@.@..........@....
.@..........@..@.........@....
......@..@@.@..............@..
.........@..@.....@@..........
.........@..@.................
.@@.........@...@.........@...
.....................@........
@.@.................@....@....
.@................@.@.......@.
..........@.......@...........
@.@.@@...............@........
..@..........@................
....@..............@..........
..........@...................
......@......@.......@........
............@.................
.@.........@...........@......
.....@........................
...........@.@.....@....@....@
...@......@.@.......@....@....
..............................
......@.........@....@........
..@@..@...@............@.@....
...........@..............@...
............................@.
@...........@....@............
...@.....@.....@..............
.@......@@....................
....@@...@....@...............
