30,30
......@........@.....@....@...
.@.......................@@..@
..@....................@......
..............@.....@...@.....
...@..@.............@.........
.....@..........@..@.....@....
.............................@
......@.....@@................
.@.....................@.@..@.
........@.........@........@..
..........@@........@.........
....@.........@...@...........
@@..@..............@.........@
..............@.............@.
..@...@.@@@.........@.@.......
...........@..................
.@..@.....@...................
..................@.@.@...@...
...............@.........@....
...@..@........@..............
.................@...@@....@..
...@......@...............@..@
..............................
....@...............@.........
..@............@........@.....
...........................@..
..................@...........
..@.............@.............
....@..............@....@.....
.....@.....@..@............@@@
