30,30
.@................@@..........
........@............@........
.@..@.........................
.......@.....@................
..@....@...............@.@....
........@..@...........@......
.................@...@........
.@.....................@......
...@.......................@..
@........@....@...............
..........@...@...@...........
.....@@.........@...@.........
.....@.@@............@..@.....
.......@......@...............
....@.....@@........@....@@...
........@..........@......@...
@@........@...................
.............@...........@...@
.....@.@..................@...
..........@...........@.......
...@..................@.......
..............................
.....@..@.....@.@.............
..@.............@........@....
....@...@..@..@...............
.......@....@............@....
.....@.....@..@..@..........@@
.....@.@.........@...@.......@
@....@........................
........................@..@..
