30,30
.......................@......
.@..........................@.
...........@..@...........@...
.@............................
.....@.@.......@@...@@.@@.....
..............@@@............@
..............................
........................@.....
..........@.....@.@....@......
......@..@.............@......
....@........................@
@......@..@.@..@.......@......
..@.........@.....@@..........
.......@......................
..............................
.......@@..................@..
@.....@...@..............@....
........@@..........@.........
......@........@...@..@.......
............@..........@......
....@...........@@..@.@...@...
..............................
...@@.............@.....@...@.
.............@................
.........@............@.......
.....@......@.@......@.......@
.....................@.......@
...@.......@@............@...@
........@...@.......@.....@...
@.....@.@.............@.......
