30,30
@...@..@....@.................
@.............@..........@@...
.............@................
@..@........................@.
.............................@
..........@..@.@@.......@@....
.....@.........@..........@@..
@@.....@...........@........@@
................@.......@.....
................@@.........@..
..........@..@...............@
..@...@...................@...
.........@...@...............@
.........@....@@..............
.............@......@.....@...
.................@.@..........
..@.......@.............@@....
.....@........................
......@...@..@.......@........
@...@@@...........@@........@.
..@........@..................
.......@............@.@.......
..@...............@...........
........................@.....
..........@..............@....
......@..@@..............@....
..............................
@............@............@...
.@@...........@............@..
.............@@...............
