30,30
....@...@....@....@.@.........
..@............@..@......@....
..............................
.@...@....@....@@.........@...
.........................@....
..................@..@@.......
..............................
.@......@..........@..........
....@.........................
...............@.........@.@..
@....@.@...@..................
....@.....@.@....@...@....@...
......@................@......
..........@...................
...@...................@...@..
@.............@@..............
....@............@............
....@@.@..@...........@....@@.
.............@..............@@
.........@.@..............@...
.............@................
..............@..........@..@.
.....................@......@.
..@........@..................
...@...............@.........@
@.............@.....@..@......
@....@...............@...@..@.
.........................@....
...............@.@............
.@.@.....@........@...@...@.@.
