30,30
.......@.....@.......@....@...
.@.@..@.@..........@.......@..
.@..............@.....@.......
..............................
@.@.......@..@@....@@.......@.
.@...........@@...............
..............@........@......
...........@.............@....
..@.@.....@.........@.....@...
.............@................
....@......@..................
...........@@..@..............
..@........@..@@.....@........
............@..........@......
@@.....@.............@........
...............@..............
............@....@@@....@@....
..........@...................
.........@....................
...........@..........@.......
..@..@..@...........@...@.....
....@..............@....@.@...
........@..@..@...........@...
.........@...............@...@
...............@......@.......
.........@....................
@..............@..............
@.@.........@...@..@..@.......
..............................
....................@.@.......
