30,30
..............@......@...@@...
...............@..............
...............@@....@.@......
...@...@...@....@@........@...
....................@.........
.........@......@..@..@....@..
.@...@....@...................
...@..........................
......@.@.....@....@...@...@..
......@......@..........@.....
...@......................@...
............@..@.@............
@...........@@.....@....@.....
...@@@.............@..........
.......................@.....@
...........@..................
..@...........................
.....................@@...@...
......@@.@.....@..............
@..@....@.............@...@..@
.@.........@.....@...........@
.....@.......@...............@
........@.....................
...@.....@............@.......
..........@............@....@.
.....@............@@....@.....
...@....@..................@..
...........@.........@........
.............................@
.........................@....
