30,30
....@.....@...................
...@...........@.......@..@..@
..................@........@..
...............@......@....@..
...................@..........
.....................@..@.....
...@....................@.....
.....................@........
..........@@.............@...@
..........@@............@.....
............@....@.@.@........
...@........@......@..........
...@.....@.....@............@.
..@...........@.............@.
....@....................@.@..
.................@............
...............@.@.@..........
....@..............@....@.....
..............................
...@............@............@
......................@.....@.
@........@..........@..@....@.
.........................@....
.....@..@...............@@@...
........@..@.....@............
@......@@..........@.@........
..@.......@....@@.............
.......@........@..@..@@..@...
........@.........@.@.........
...@@.......@...........@.....
