30,30
..........@...................
..................@....@.....@
..@....@..........@........@..
..........@................@..
........@.....................
@@..@......@@.................
........@.@.........@.........
.................@@...........
..........@...........@.......
.....@.....@............@.....
.@...@....................@...
.....@.........@..............
...................@..@.......
..........@.........@@........
......@...@...@........@......
...............@.........@....
@.@....@......................
..@..@.....@..................
...................@.@.....@..
@.............@.........@...@.
..@.@.........@@.......@...@..
@.........@.....@.........@...
....@.........................
......................@...@.@.
..@........@.................@
..@.......................@...
@....@..........@@........@@..
..............................
.@..........@..@...........@..
...........@....@@@..@@.......
