30,30
.....@.....@.............@....
..........................@...
.....@..........@....@.....@@.
@...@......................@..
@..................@..........
..............@.@@..........@.
@............@................
..@......@.........@..........
@.........@@...@..@........@..
..........................@...
...@....................@.....
....................@.........
...@....@..@.............@@...
......@............@....@.....
@@.......@@...@@...@..........
..............................
.....................@.......@
.....@.........@...@.@.....@..
....@...@.....................
@............................@
....@...........@.......@.....
............@..@.@............
@.@...........................
.......@@..............@......
.@@.@..................@...@..
..............................
..@...@.....@.@@..............
...@.................@....@...
............@..@.........@@...
..............@......@@.......
