30,30
..........................@...
...........@.........@@@......
...@.@@...@................@..
.....@................@.......
......@..........@............
@...........@.....@.......@@..
.@..........@........@........
...............@...@..........
@.@....@@@............@.......
......@.....@.......@..@...@.@
.......@......................
.....@....@@.................@
.........@....................
.@...............@............
@..........................@..
..@...@...@.@@..@............@
...............@..............
......@...@.@.....@...........
.............@........@@......
..........................@...
.....@..........@....@@.......
....@........@..@.............
........................@.....
.......@........@.............
....@...@...@.....@...@....@..
......................@.......
.............@.........@......
.....@........................
......@.......@........@.....@
..........@........@.......@.@
