30,30
@..@...................@.@....
..@.@.@.@.........@..@........
.@..........@.................
......@...................@...
..@.....@.............@.@.....
..............................
..........@........@.....@..@.
...........@..@........@..@...
.@.@..........................
....@.........@..@.....@..@...
....@.......@..@@..........@..
....@@.@...............@@.@...
..@@..........................
............@.................
........@..........@.@.......@
....@@..@.....................
.......@.............@....@...
............@.................
.@............@..@...@........
.............@......@.........
.........@........@.........@@
..............................
......@....@....@.@...........
...@..@..........@.@@.........
...........@.................@
....@@.......@............@...
@.....@...@...................
......@....@.....@............
..............................
........................@.....
