30,30
..............@...............
.....................@...@@...
..........@.........@@........
........................@.....
....@.................@.......
@...@..............@@.........
.@..@..........@.............@
..................@...........
..............@...............
@.........@..@@...............
.............................@
............@.@......@.......@
.......@.@.@@.............@...
.............@.@@..@..@.......
.@@.....................@.....
.......@............@....@....
..@..................@..@.....
....@...@.@..........@.@...@..
.................@.@..........
.............@........@.......
............@............@....
.....@....................@...
.....@.....@............@.....
.@......@.....@..@............
.@..........@.....@.........@.
.............@..............@.
..@............@......@@.@..@.
.....................@.....@.@
.....@.....@......@...@.......
.@..@.........................
