30,30
..............................
..@....@@...@.....@@..........
.........@......@.........@...
...@......@...........@.......
.............@....@.....@.....
...............@......@..@.@..
...@......@..............@.@..
.....@........................
..........@..@....@.@...@.....
@....@.................@.....@
.......@......@.@@...@......@.
....@@........................
.............@.......@........
...@........@.................
...@..........................
.@@.......@..................@
.@.........@..............@...
@...@.........................
.....................@.......@
.@.....@.....@.........@..@@..
..........@......@........@...
....@....................@@...
@.............................
.......@.@...................@
@..........@..................
.@............................
...@...@......@.........@.@...
........@.....................
.......@........@....@........
....@...@@................@.@.
