30,30
..@@...............@......@...
....@.........................
..........@.@........@..@.....
......@@...................@@.
...@..........................
..........................@...
....@............@..........@.
..........@...................
......@..@..........@.....@...
...........@......@...........
......@.....@.................
.........@...........@..@.....
..@.........@.................
........@....@.........@.....@
.................@...........@
......@................@.....@
............................@.
.@...@.@....@.........@.......
....@.................@..@.@..
........................@.....
..@......@..@.........@..@@..@
........@@...............@.@..
.........@.......@............
@.............@@.@............
.....................@........
................@.@....@......
.....@......@.................
.......@..@.@..........@......
...@......@@.@....@....@...@..
..@........@.....@...........@
