30,30
.......@...@....@..........@..
........@.....................
.........................@....
@....@.@...@@..@.......@......
...........@..@.@......@......
.@....@..@......@.........@...
..........@.............@.....
..........................@...
.........@....@..@.......@....
.........@......@...@.@.......
...........@..................
........@.....................
.................@@....@......
.......................@......
.@..@...........@.............
@.....@........@@.@..@........
......@.......................
......@.......@@..............
......................@.......
........................@.....
.....@.@@....@................
.........@....................
.@....@..............@..@...@.
.....@......................@.
..@......@@.@......@@..@.@@..@
.....................@....@...
@............@.....@...@......
........@.....................
..........@.......@......@@...
...............@.....@..@.....
