30,30
.....................@.....@..
.................@............
.@............@..........@....
..@...............@@.@...@.@..
..............................
...........@...@..@.....@.....
....@..........@......@.......
...............@..............
.......@.....@.@@@............
.............@..........@....@
@...........@.................
......@..@....@......@....@...
....@......@..@...............
@......@......................
........................@.....
..............@..........@....
............@.................
........................@.....
@.....@.@.........@.@@@.......
@.....@.................@.....
...@.......@...@..............
.....@..@.@...................
...........@....@.............
..........@.....@.............
@.@.......@..@.@..@.@.@.......
.....@...@.....@.....@........
@.......@...@.@....@..@.......
.........@....................
..........@@..................
..@......@...........@..@.....
