30,30
.....@..@...............@@@...
...........................@..
@.....@...@...................
......@.......................
...@.....@.@......@.........@.
.@............................
.@............................
..@..@......@.@@...@....@...@.
...........@..@...............
.....@............@..@..@.@...
@.......@..@...@..............
....@..................@.....@
..........@...................
..............................
...........@.@......@.........
........@@....@@..@.....@.....
...@...@......................
.@...........@................
....@..........@.............@
........@..........@....@.....
...........@...........@..@@..
.......@@........@............
........@................@@...
.@.......@@..........@........
.....@.@.....................@
.............@......@..@....@.
............@.........@.......
...........@@...........@@....
............@...............@.
..............@............@..
