30,30
..........@....@@.....@.......
......................@.....@.
............@...@..........@..
@........@.@..........@.......
...........@...........@......
................@......@......
@..........@......@...........
.....................@.@......
........@......@...@........@.
..........@..@@...@...........
.............@......@..@.@...@
....@@...@....................
.....@.@...@...............@..
@...@....@@...................
..............................
...@......................@...
....@@........................
...............@..............
.@.......@@.@.@...@.@.........
.@............................
...@..............@....@......
...........@..................
.....@..........@.....@.......
........................@....@
.....@.....@..@......@..@.....
.@............@......@........
.....@...@..@.@............@.@
...................@.@....@...
...@........@....@.....@......
...........................@..
