30,30
@.....................@......@
..@............@...........@..
...@...@...............@......
..........@......@......@..@..
..............................
@......................@..@...
..............@.....@.........
......@..........@...@........
..................@...........
.@..........@.......@.@@......
..@..@.....@@..@@........@....
...@.....................@....
................@@.@....@.....
@..........@...........@......
......@.....................@.
...........@..................
...@.........@@..@............
...@......@...................
....@..........@.@.....@......
...........@@......@....@.....
..............................
.................@..@....@....
...@..@@@..........@......@...
.....@...@.@.............@...@
.........@..............@.....
...@.......@..@@.........@....
@..........@.......@..........
.................@............
............................@@
........@.....@......@........
