30,30
.@...@............@...........
.........@@.....@.@...@.......
...@.........@................
.......@.......@....@....@.@@.
.............@................
...@..........................
.@.............@..........@...
..........................@...
............@.@...............
.........@..................@.
.................@............
.....@....@..@@............@..
.....@.............@..@@@@....
......@..@......@..........@..
.....@...@@....@.....@.....@..
.@..........................@.
....@........@........@.......
..............................
.........@........@...........
..........@..@@...............
...@.....@........@.@....@....
......@..@....................
.@@@.@...@...................@
...........@.......@.@..@.....
..........@.........@...@.....
.@.@........@.....@...........
......@..........@............
.............@................
..........@..................@
.........@@.......@...........
