30,30
.........@.@....@...@.........
......@.........@....@..@.....
.@....................@@......
........@.....................
.@.....@.................@....
................@.............
@...@..@..............@..@..@.
.................@...@@.......
.....@........................
...@@.........................
............@...........@@..@.
@.......@@.........@..@@...@..
.........................@.@..
........@..............@....@.
...................@@..@......
.............@.......@........
...............@......@.....@.
.....@.........@.@...@........
...@@..@...........@.....@....
.@..........@.........@.......
...@@..........@....@......@..
.@........@....@@.........@...
.......@......................
..@......@.@......@......@...@
............@.................
..........@...@...............
...@................@.........
................@.............
......................@.......
........@........@............
