30,30
................@.............
......@@.....@..@.............
...@...........@........@.....
................@.@..........@
............@.......@.........
.............@........@.....@.
........@..........@@.........
.......................@@....@
...............@..........@..@
..@......@............@@......
......@...............@....@..
.........@.@.........@......@.
......@.......................
.@......................@.....
.............@@.@....@.....@.@
....@......@......@...@.......
...@.........@...@............
..@@....@.......@............@
......@..@@................@..
..........@.........@.....@...
....@..........@..............
.......@@..............@......
...@..@.......................
.............@@........@......
.................@............
..................@.....@.....
.....@.....@....@.............
@...................@.........
.....@.......@.............@.@
....@..........@......@...@...
