30,30
@..@.....@...........@....@..@
.............@................
..@...@.@.............@.......
...............@..............
...............@..........@...
.@............................
...........@.@@...........@...
@...............@.......@.....
........................@..@..
.@.......@.@...@..@.@@........
....@.......................@.
........@........@......@.@...
@..........@......@...........
......@.............@.........
....@....@.@.......@..........
.....@@.......................
@@.........@......@......@....
.@.......@.............@......
............@.@...............
.....@............@...........
.@...@.......@@..@...@........
..........@.......@...@.......
@....@...............@........
.....@...@........@.........@.
.......@......@...............
.@.................@..........
.....@..@.....................
..@............@...@..........
.......@......................
..............@@......@....@..
