30,30
......@....@.@................
....@@............@.@.......@.
...@......................@...
......@..........@..........@.
....@......@.....@............
@...@...@.....................
@......@.@.........@@.@.@.....
..@.@................@........
........@..............@.....@
..................@.@....@....
.......@............@.........
...@..........................
..@...@.@.......@.........@@..
..............................
...@@.................@.......
@....................@..@.....
....@...@.@...................
...................@.....@@...
...@@....@.@.............@....
.....@...@.........@..........
.....................@........
..............@....@....@.....
..@......@..@@.......@.......@
..@.........@.......@.........
..@.....@........@............
.................@...........@
............@.....@.........@.
.......................@......
.@....@.@.....................
.......@......................
