30,30
..............@.....@@..@..@.@
.......@...@..................
..............................
.@...@....@.........@...@.....
..@.....@.....................
.........................@....
..............@...............
......@............@..........
...........................@..
.......@..@...................
............@...............@.
@@@..@..@........@.....@......
.....@.............@..........
.@..........@.................
............@.@@...@....@....@
.........@..............@@....
.....................@........
..................@...........
..........@.....@.............
.......@.......@...@..........
...........@@...........@....@
....@............@@@.......@..
...@......@....@..@...........
.....@....@...................
....@.....@.........@...@.@...
....@.@.....@@.............@@.
.......@......@.........@.....
..@.@.........@....@....@.....
.................@.....@......
......@.........@.....@.......
