30,30
.....@...@....@......@@.@@....
...@.....................@....
.@......@@....................
............@......@@@........
........@.....................
.....@.@..@..................@
.@.....@....@@.@..............
...................@....@.....
..@..........@................
..........@......@......@.....
....@...........@...........@@
..............................
@....@......@......@.......@..
..@.@..@@..........@.......@..
.@@........@...........@@..@.@
...@............@.............
..............................
...............@..............
..@.@@..@............@........
............@....@......@.....
.@......@......@..............
.......................@..@...
....@............@.@..........
........................@.....
...@.......@..................
....@..................@......
...@.@........@...............
...................@.......@..
.............@........@.......
...@..............@......@...@
