30,30
.........@.@........@.......@.
............................@.
............@..............@..
@............@..............@.
..........@...........@.......
..@....@..............@.@.....
.@...........@...@.......@..@.
.....@........................
..@....@..............@.......
...........................@@.
.@..@....................@....
....@...@.@...................
.....@.@...@.@.@@...@.........
@..........@.............@....
...@..............@...........
...............@..@......@..@.
......@.............@.......@.
.@............................
...........@..............@@..
@.......@.....................
.@....@...@..........@........
....@....@....................
....@..........@..........@...
..@...@.....@......@..........
...........@@.@.....@.........
...................@...@......
@..@.......................@..
@....@..............@@........
..........@...........@.......
@@@....................@......
