30,30
................@.............
@...........@..........@......
..............................
..............................
.........@..............@@..@.
.............................@
................@...@.....@...
.@@..........@....@.......@...
....@.........@...............
..@..@.@......@....@..@......@
.......@..........@...........
.............@..@..........@@.
..........@...............@@.@
....@.....@.@......@..........
.....@.....@@.................
..................@...........
.........@.@.............@....
.........@..@.......@.........
......@.@.....................
.@@@....@@....@.........@.....
..............................
..................@.@....@..@.
.............@................
......@..@...........@...@...@
.................@...........@
..............@...@...@.......
...........@......@........@.@
...@..@.............@.........
....@.@@.....@.......@........
@.........@.........@.......@.
