30,30
..........................@...
.......@..............@.@....@
..............................
.......................@......
@..................@...@....@@
.@.........@..@............@..
..................@...........
.......@........@......@..@@..
.....@@...........@..@........
................@@.....@......
........@....@@...............
......@............@........@@
.......................@......
..........@...@....@.........@
@..................@..........
........@.....@...@...........
..........@...............@...
..@@...@.@......@..@....@..@..
.............@................
....@...@......@....@.........
.....@....@..............@....
....@.......@.@@.......@...@..
..............................
.......@....@..@@...@...@.@...
.@..................@.........
..............@...............
......................@.......
...............@.........@....
..............@@..............
@@@.........@......@......@...
