30,30
.............@................
...@..........................
..........@...................
....@.@.@.@.......@...........
...............@...@@.......@@
..@............@..@...@..@....
.......@.......@.@........@..@
@............@....@...........
....................@.........
....@..@............@.........
@...............@....@.@......
.........@..@@..@...@.@..@....
...@..........@.....@...@.....
...@......@...................
.@.......@..@...............@.
@............@.........@...@@.
..........@......@............
.@....@..........@......@..@..
........@.....................
..@.............@...@........@
.@...............@............
................@...@..@......
............@........@........
.......@...........@.......@..
.....@.@......................
..................@..@........
.........................@....
......................@...@...
.........@....................
..@...@@@.....................
