30,30
...@.......@.........@........
..............................
..@......@.......@............
.@...@...@..@.................
..@....@.........@.......@....
..@.....@..............@.....@
............@.................
@..@...@...............@......
............@.....@...........
...................@@......@..
.....@............@...........
....................@......@..
......@..............@........
................@...@....@@...
..............@..........@....
..............................
...@..@.................@@....
.......@......................
...@.....................@....
....@..@..@.@...@.............
.....@............@........@..
....@.......@..........@..@.@.
..............................
....@..@@..........@@@........
........@...@..........@@.....
@..........@.........@........
.@....@....@......@..........@
........@.....................
...........@...@........@@.@..
.@...@@.@...@..@..............
