30,30
@.........@...................
........@.@.................@.
......@........@.......@......
@.@.@.........................
...........@......@.......@@..
.............@................
..@..........@...@.......@....
........@..............@......
......@..@..............@...@.
........@@................@...
..@..................@........
.............@..............@.
.......@.......@..@...........
..............................
.........................@....
..@......@.......@.....@.....@
.....@............@...@....@..
...@.................@....@.@.
......................@.......
@@........@........@..........
.@..@.........................
......@......@@.........@@....
......@.@.....@.........@.....
...............@@.@...........
........@........@.@........@.
.....................@.@......
........................@@...@
.@@...........................
.@.@.........@..@....@....@@..
..........@....@.......@......
