30,30
.@.@...........@......@.@..@..
.@....................@.......
.......@.........@........@.@.
........@@................@...
..@..........@.....@.@...@....
.............@........@..@....
........................@.....
....@.......@.................
@..........@....@@............
...@..............@...........
...................@.........@
.@.....................@......
.....................@........
......@...@.@...........@@....
.....@...............@..@...@.
...........@.@.......@....@.@.
..@....@..@......@.@.@........
.........@.....@.@.........@..
.......@...........@..@...@...
...@@....@.................@..
..............................
..................@..@........
.@@.........@........@..@...@.
@.............................
@.....@..............@...@....
..@...........................
.........@...@.........@......
..............................
@.............................
......@.....@......@..........
