30,30
@.....@.............@.........
@.@....@.@....................
......@........@.......@..@...
...........@.........@.@......
...@@................@........
.....@...........@..........@.
..........@..........@........
.@.................@..........
.......@...............@......
.....@.............@..........
..................@...@.......
.....@.............@..........
..........@.@...@......@..@..@
.......@........@...@.........
........@....@...@......@.....
...@.............@@..@...@....
..@....@....@.................
..............@.......@.......
............@.................
....@............@...........@
.@............@..........@.@..
....@.......................@.
...@...........@....@.........
...............@....@....@....
.............@..@.........@...
.......@....@.........@.@.@...
............@@...@......@.....
.@........@.@...@.............
.....@........................
..................@@..........
