30,30
..@............@...@...@......
...........@...@....@.........
.@...........................@
.........................@...@
.........@..@.@@......@..@....
...@.........@.......@........
...............@......@.......
..............................
...@......@.@............@....
......@...@..@..@............@
....@............@....@.......
.@..................@....@....
..@@...@.....@..............@.
.@@.........@.........@...@...
..........@.@.............@.@.
........@.@......@............
...........@....@.....@.....@.
.............@.@...........@..
....@.@....................@..
..@.....@...@....@.@..........
..............@...............
.............................@
..............................
......@.@.......@.............
..@.....@.......@.............
............@.@............@..
@.......................@...@.
..........@...................
@.@.......@.....@.......@.....
.............................@
