30,30
.@.....@.@@......@...@@.......
.............@................
..@.@...............@....@....
.......@....@...@......@....@@
.........@....................
@..............@........@.....
.....@................@.......
@@...........@.....@........@.
.....@....@@..............@...
..@............@.......@......
................@.............
......@.....@.....@.....@.....
........................@..@..
..@........@..................
..@..................@......@.
......@..............@........
....@.........................
.@.............@..@......@....
......@......@.......@..@...@.
...........@@.................
...@........@.........@.......
..............@..@............
...........................@..
.........@....................
....@......................@..
............@.@.....@.........
..@..@@.............@........@
...@..........@.@............@
@.......@......@....@........@
@...........@.................
