30,30
@..@....@.....@..@......@.@..@
...@............@......@..@...
............@.........@@....@.
.@............................
...........@..............@...
....@@@@......................
.............................@
.......@...........@..........
@...@.......@.............@...
......@..........@........@...
.....@........................
..............@...@...........
..............................
.@.@.......@@......@..@.......
............................@.
@......@...........@..........
.@.@....@@...@@......@@.......
......@.............@@....@@..
....................@@........
..............@............@..
...........................@..
.@...@.....................@@.
...@...............@...@.@.@..
.@..........@................@
........................@..@..
@.............................
........@................@.@..
..........@..............@....
.........@..........@.........
.@..@@..@.....................
