30,30
@.............@..@...@........
.......@.............@..@.@..@
..@..@...................@...@
.............@.........@@.....
....@...@........@............
..........@.@...........@.....
.....@.....@.............@....
.........................@@...
.........@.@.......@..........
.@.....@.................@....
.@.........@.....@............
...@........................@.
............@.........@..@....
......@.......................
.......@............@.@.......
.................@@.@....@....
.....@...............@..@@....
...@...........@..............
.....@....@...@....@........@.
...............@..............
..........@.........@...@.....
.....................@........
.@....@.........@..@....@.....
..........@............@......
@.........@..........@........
..................@...@.......
.@.......@@.....@......@......
..............@........@......
@.......@..@.....@@...........
........@.....................
