30,30
..@...@...@...................
...............@..........@...
.......@.................@..@.
@.@.......@.....@@@.........@.
..............@.......@.......
.........@..@..@.@....@.......
...........@.@.......@@.......
@......@......................
....@.....................@...
@......@....@..@....@.........
....................@.@.......
@.................@..........@
......................@..@..@.
..............................
...@........................@.
..@@@...........@.............
........................@@....
@...................@........@
......@.......................
........@.......@....@........
.@...@..................@@..@.
@.............@...............
..@.@.........................
...@....@...................@.
...........@.......@..@......@
@................@.........@..
......@.......@............@..
..........................@...
........@...@@....@....@......
.........@....@...@....@......
