30,30
@...............@@..@......@..
.....@...@..........@...@.....
........@.@@......@...@.......
.....@.........@.@............
.@@.............@........@....
.........................@....
@@...@............@.@.........
......................@@@.....
....@...@.............@......@
....@.....@....@..............
@......@.....@................
.............................@
..............................
........@.........@...........
..............................
....@........@@..@............
@......@......................
.......................@....@.
..............@.......@.......
....@.@..........@...@........
.........@.........@...@.@....
.....@......................@.
........@@...............@....
..@......@........@@.@........
.@.......................@.@..
@...........@.......@....@..@.
.......@......................
...@............@........@....
@.........@.....@......@......
.........@....@.@.............
