30,30
........@.@@..@....@.@........
......@.......................
........@......@......@.......
...........................@..
.................@....@..@....
..............................
..........@...................
...............@.@...@.....@..
.....................@........
........@.@...........@...@...
.............@.............@..
.@.@...@...@.....@.........@..
................@......@......
.@.............@..@.@.....@@..
.......@.@..............@..@..
.@..@......@@...........@.....
.....@...............@........
.@......@..@......@...........
..@@........@..@..............
.........@................@...
.......................@@.....
.@.....@..........@.........@.
@.............................
..@..........@...@......@.....
....@............@...@........
.@....@@......@@......@.......
..............................
..........@...................
...@.........@..@.............
....@.@@...@.....@............
