30,30
..@.......@.................@.
...@....@..@.........@........
....@.........................
.....@....................@...
........@...@..@..@...........
.......................@.@.@..
@..........@.@........@.......
..............@@..............
...........@.........@........
..@......@................@...
..@......................@....
...@........@.................
....@.@...........@...........
..@...@..........@............
.....@...@.........@....@.....
.......@.............@@.......
.@..@@........................
.......@............@......@.@
..............................
.@..@...........@...........@.
.............@.@..........@@..
.............@@...............
...................@.......@..
......@..........@..@.......@.
.....@..........@.@...........
..............................
......@..@..@@..@.....@.......
@..........@....@@......@..@..
.....@.....@..@@..........@...
......@...@...................
