30,30
..............@.......@.......
@........@...@......@......@..
@.......@....@.........@......
...@@..@...@.@..........@..@..
..............................
........@............@........
............@.@...@........@@.
....@........................@
.......@........@@............
...@............@......@......
................@...@..@......
@.............................
.@.@@...........@.@...........
.......@......................
..............................
.....@@.............@.......@.
@....@.@@.....................
.....@.....@..................
.........@......@@..@......@..
..........@..@@..@............
...@......@....@....@.......@@
..@@.................@........
..@..@....@..@................
....................@.......@.
..............@...@........@..
............................@.
..@.......................@...
......@@@.....................
......................@....@..
.......@...........@..........
