30,30
...@....@.....................
...................@..........
.............@.@@.............
...............@..............
...........@..................
........@@..@...@@...........@
...............@.......@..@...
@@..........@@........@.......
....@....................@....
.@.........@..@...@......@....
...@.......@.................@
........@..@....@@@.@....@....
................@.............
........@.....@........@....@.
........@...........@.........
...@........@.................
@...@.............@...........
.....@@......@.....@..@.......
.......@......................
@......................@......
...........@........@@........
@...@.........................
......@...@.......@...........
..............................
...........@..................
@....@@....@..........@.......
....@.....@..@........@.......
.......@.@.......@............
..........@.@.@..........@....
@..........@@.......@......@.@
